【実践】新規事業の成功率を、格段に引き上げる方法とは	<方針>,<レビュー>	<レビュー>
名古屋大と名大発ベンチャーのミサリオ、温めると縮む新材料「ピロリン酸亜鉛マグネシウム」微粒子化に成功（日刊自動車新聞） | 自動車情報サイト【新車・中古車】 - carview!	<技術開発>	<技術>
東北大学、多様な機能をシームレスに集積化した微細カテーテルの開発に成功	<技術開発>	<技術>
中央大・日大・金沢大など、「過去最高の物理吸収量を持つCO2吸収液（イオン液体）の理論設計とその迅速具現化」に成功 - 日本経済新聞	<技術開発>,<市場動向>	<技術>
太陽電池の発電効率2倍に成功、広島大学が有機半導体を高結晶化 ニュースイッチ by 日刊工業新聞社	<技術開発>	<技術>
液体でできた微小なレーザ光源の開発に成功 | e.x.press	<技術開発>	<技術>
大企業が新規事業開発でぶつかる3つの「壁」とは？ソーシャル事業を成功に導くコツを考える	<レビュー>	<レビュー>
水と同じ密度を持つ氷「ガラス化したH2O」の作成に成功！	<技術開発>	<技術>
日本が全固体電池の開発に成功、中国自動車企業は危機感を―中国メディア	<技術開発>	<技術>
優れた電池特性を有するマグネシウム正極材料の開発に成功<br>～高エネルギー密度のマグネシウム二次電池の実現に向け大きく前進～｜東京理科大学	<技術開発>,<目標>,<業界情報>	<技術>
｢無駄なこと｣｢寄り道する｣人が仕事も成功する訳	<レビュー>	<レビュー>
高伝導率の配線をデバイス上に容易に描画できる技術の開発に成功<br>～従来よりも簡便かつ低コストで作製が可能、貼り付け型センサなどへの応用に期待～｜東京理科大学	<技術開発>	<技術>
ＣＯ２原料のパラキシレン　ハイケムら、製造・単離に成功	<技術開発>	<技術>
「0→1」と「0→0.1」の並走で新規事業を生み出す時代へ - オープンイノベーション成功の秘訣とは (1)	<コラム>,<目標>	<オピニオン>
未来予想図の構築と共有で成功を目指す、ヤマハ発動機の新規事業開発（JBpress）	<方針>,<目標>,<時制.未来>	
究極な薄さの強誘電体原子膜の合成に成功 ～60℃の低温水溶液プロセスで実現、デバイスの小型化にむけて期待～	<技術開発>,<見解>,<要望>	<技術>,<政策>,<オピニオン>
有機EL「再結合」過程観測、大阪公立大などが成功した意義 ニュースイッチ by 日刊工業新聞社	<技術開発>,<研究>	<技術>
モノマー単位へ解重合に成功　産総研、スーパーエンプラで	<技術開発>	<技術>
東大ら、超伝導の新たなメカニズムの検証に成功	<技術開発>	<技術>
物材機構・アイシンなど、照明排熱で路車間通信に成功した仕組み ニュースイッチ by 日刊工業新聞社	<技術開発>,<レビュー>	<技術>,<レビュー>
“国内初”VRを活用した半導体材料開発に成功	<利用・採用>,<技術開発>	<技術>
プログラム可能な準生命体「サイボーグ細胞」の開発に成功！	<技術開発>	<技術>
水素・ホウ素の核融合成功 - 日本経済新聞	<技術開発>,<市場動向>	<技術>
アルツハイマー治療薬を効率的に脳に届ける技術 実験で成功 | NHK	<技術開発>	<技術>
巨大な細孔を有する超軽量の多孔質材料『TUS-64』の創製に成功<br>～徐放性のドラッグデリバリーシステムとしての活用に期待～｜東京理科大学	<技術開発>,<利用・採用>	<技術>
三菱マテ・東工大が合成成功、新しい結晶構造「酸化スズ」の実力 ニュースイッチ by 日刊工業新聞社	<レビュー>	<レビュー>
新たな結晶構造を持つ酸化スズの合成に成功－人工光合成への応用が期待でき… | ニュース | 三菱マテリアル	<技術開発>,<レビュー>	<技術>,<レビュー>
液体でできた微小なレーザー光源の開発に成功〜大気中で安定かつ気流で形状を制御可能〜 | TSUKUBA JOURNAL - テクノロジー・材料	<技術開発>,<レビュー>	<技術>,<レビュー>
「空飛ぶクルマ」、日本初の有人飛行に成功　中国EHang社の機体を採用（36Kr Japan）	<政府・宣言>,<利用・採用>	<技術>,<政策>
北大ら，hBNの⼤⾯積化とグラフェン集積に成功	<技術開発>	<技術>
AirbnbもiPhoneも逆風を越えて成功　「本当に良いアイデア」が多くの人に賛成されないのはなぜか（マネーポストWEB）	<レビュー>	<レビュー>
ナノバブルでワサビの発芽率が3倍超に！ イオンとの相乗効果による新機能の発現に成功	<市場データ>,<技術開発>	<技術>
半導体ポリマーの結晶化促進により有機太陽電池の高効率化に成功（プレスリリース） — SPring-8 Web Site	<技術開発>	<技術>
〔2023年2月6日リリース〕環境にやさしいヨウ素を用いる炭素-炭素結合形反応に成功〜創薬シードの創出研究を加速〜 | 2022年度 プレスリリース一覧 | プレスリリース | 広報・社会連携 | 大学案内 | 国立大学法人 東京農工大学	<商品化>,<技術開発>,<研究>,<提携>	<技術>,<製品サービス>,<提携>
東大と東邦大、炭素≡炭素三重結合を保持したまま新しい不斉炭素—炭素結合の形成に成功 - 日本経済新聞	<技術開発>,<市場動向>	<技術>
マイクロメートルサイズの微小な粉状結晶の電子構造測定に初めて成功 次世代半導体開発や微粒子の物性解明のブレークスルーに	<技術開発>,<目標>	<技術>
少ない機械学習でロボットアームが約95％の作業成功率を実現する新技術（MONOist）	<技術開発>	<技術>
名大、厚さ0.9nmのアモルファス・シリカの合成に成功	<技術開発>	<技術>
ＡＩが「うつ病」を高精度診断、脳の血流解析で罹患見逃さず…広島大など成功		
立命大，液晶滴で微細電極周囲の電場の可視化に成功 | OPTRONICS ONLINE　オプトロニクスオンライン	<技術開発>	<技術>
CISを用いた可視光通信で512色エラーレス伝送に成功	<技術開発>	<技術>
28GHz帯での世界初の実証実験に成功！回路規模を約1/10に低減する高効率な5Gマルチセクタアンテナ屋内基地局装置を開発 横浜国立大、ドコモ、日本電業工作、富士通 - ロボスタ	<技術開発>	<技術>
シニアの成功者に教えてもらった「円熟の境地」	<レビュー>	<レビュー>
総務部がオラクルでDX？--IT専門職ではない社員によ る“データドリブン・マーケティング”はいかに成功したか？	<レビュー>	<レビュー>
御社の「負け犬」事業を高収益に変える一手とは　成功企業に学ぶリ・インベンションの5パターン（東洋経済オンライン）	<コラム>	<オピニオン>
新着情報: 中性子ビームを使った新しいサーモグラフィの開発に成功～産業製品内部の様々な熱エネルギー問題の解決に期待～（工学研究院　准教授　佐藤博隆）	<技術開発>	<技術>
木質バイオマスやポリエステルを高効率に原料化、新たな触媒の開発に成功（スマートジャパン）	<技術開発>	<技術>
金属酸窒化物半導体ナノシートの合成と光吸収特性の制御に成功～光触媒、誘電体材料、エネルギー変換材料などへの応用展開が期待～	<技術開発>,<業界情報>,<方針>	<技術>
はじめての『デザイン思考』基礎講座｜成功するための前提を知っていますか？ (2023/03/08 18:00〜)	<レビュー>	<レビュー>
ビル･ゲイツが絶対に崩さない｢過去のとらえ方｣ 1986～1999年､起業から大成功を収めた頃の生声 - 記事詳細｜Infoseekニュース	<コラム>,<意見>	<オピニオン>
アルミ形材の実際の製造設備で水素利用、工程間CO2排出ゼロの熱処理に成功＝東京ガス／LIXIL	<利用・採用>,<技術開発>	<技術>
公大ら，有機ELの「再結合過程」の観測に成功 | OPTRONICS ONLINE　オプトロニクスオンライン	<技術開発>	<技術>
【世界初】ドコモが窓に貼って室内からビル屋外へミリ波通信を届ける「透過型メタサーフェス」実証実験に成功 - ロボスタ	<技術開発>	<技術>
液体でできた微小なレーザー光源の開発に成功 | 研究成果 | 九州大学（KYUSHU UNIVERSITY）	<技術開発>,<研究>	<技術>
「ChatGPT」の成功がAIに与える非オープン化の弊害、第一人者のベンジオ氏が警告	<コラム>,<業界情報>	<オピニオン>
【DX格差拡大中 #2】DX先行企業2社が放つ、成功という名の「光」～うまくいく企業は、何が違うのか	<レビュー>	<レビュー>
動的核偏極磁気共鳴法による炭素材料表面の微細構造の解析に世界で初めて成功－次世代の炭素材料の開発と利用促進に貢献－ - 国立大学法人 岡山大学	<技術開発>,<説明>	<技術>,<レビュー>
理化学研究所　CO2を利用したアルケニルエステルの合成に成功 – 日刊ケミカルニュース	<技術開発>	<技術>
なぜ「社長がひとりで事業戦略を考えている会社」は成功できないのか？	<レビュー>,<障害>	<社会>,<レビュー>
持続可能な水素社会実現に向けた高性能人工酵素へのヒント ～[NiFe]ヒドロゲナーゼ活性中心の構築過程の解明に世界で初めて成功～（プレスリリース） — SPring-8 Web Site	<目標>,<レビュー>,<技術開発>,<商品化>	<技術>,<製品サービス>,<レビュー>
東大など、フラーレン1分子の電子放出位置を1nm以下で制御することに成功 (1)	<技術開発>	<技術>
前例と成功体験にとらわれて抜けられない！　成長が鈍化した企業に必要な考え方 | THE OWNER	<障害>,<コラム>	<社会>,<オピニオン>
温めると縮む新材料「ピロリン酸亜鉛マグネシウム」の微粒子化に成功 ～電子デバイスの内部部材など微小部材の熱膨張制御に期待～	<技術開発>	<技術>
EUV露光の高出力化をもたらす光源プラズマ流観測に成功 | e.x.press	<技術開発>	<技術>
imec、SiフォトニクスプラットフォームとSiN導波路技術の統合に成功	<技術開発>	<技術>
JSTと東大、高周波/パワーデバイスの2次元電子ガスの可視化に成功 - 日本経済新聞	<技術開発>,<資金>,<市場動向>	<技術>
東京ガスとSCREENホールディングス　電解質膜の大型化に成功　水素製造を後押し | 電波新聞デジタル	<技術開発>,<支援>	<技術>
Microsoft、ChatGPTによる自然言語でロボットの制御に成功	<技術開発>	<技術>
光の螺旋性で結晶のキラリティー制御に成功	<技術開発>	<技術>
【リスキリング成功術】変化に強い自分をつくる“学びの投資”とは	<コラム>,<投資>	<オピニオン>
東京農工大、細胞膜に結合するペプチドによって人工細胞の変形を誘起することに成功	<技術開発>	<技術>
【富山高専】「合金型ナノ粒子担持触媒を短時間かつワンプロセスで合成する手法」の開発に成功	<技術開発>	<技術>
「こんな発言したらどうなるか」がわからぬ人は成功できない当然の理由	<レビュー>	<レビュー>
東工大がほぼ同一のフォトン生成に成功　量子ネットワーク実現へ重要な成果 (1)	<技術開発>	<技術>
世界初、アンペア級・1700V耐圧級のコランダム型酸化ガリウムSBD開発に成功！	<技術開発>	<技術>
名古屋大学ら、熱膨張抑制剤の微粒子化に成功	<技術開発>	<技術>
自動運転の「死角」なくします　NIMS・アイシン・茨城大学など「小電力無線路車間通信」に成功｜大学・研究｜紙面記事	<技術開発>,<研究>	<技術>
【弘前大学】世界初！がん幹細胞の考慮により臨床の放射線治療効果の予測に成功 -- 基礎細胞実験と臨床研究をつなぐ予測モデルを開発	<技術開発>	<技術>
3/9（木）デザイン思考 Webセミナー開催（参加無料）【 DXを成功させるためのデザイン思考 】	<セミナー>	<イベント>
VW、電気自動車を活用した再エネ充電の実証実験を成功裏に終了(ドイツ) | ビジネス短信 ―ジェトロの海外ニュース	<サービス終了>	<製品サービス>
【データマネジメント2023】個別対応からの脱却！～成功事例にもとづくデータモデルとサービスプラットフォームで利活用を迅速化～：Hitachi IoT Platform Magazine：日立	<技術開発>	<技術>
養殖に救世主、温泉に生息する微生物がヒラメの成長促進　大分・別府のバイオ企業が培養成功（産経新聞）	<技術開発>	<技術>
新規事業より得意な既存事業に集中したくなるのは成功の罠　コア事業も深化させながらイノベーションを実現した企業事例	<戦略>,<技術開発>	<技術>
成功したいなら「モチベーション」に頼るのをやめるべき理由	<レビュー>	<レビュー>
KDDIのメタバースサービス「αU」は何が新しいのか？　ビジネスとして成功するカギは？（ITmedia Mobile）	<レビュー>	<レビュー>
中国がリードするＬＦＰバッテリー、韓国企業の追撃成功するか（中央日報日本語版）	<レビュー>	<レビュー>
富山高専、「合金型ナノ粒子担持触媒を短時間かつワンプロセスで合成する手法」開発に成功	<技術開発>	<技術>
マグネシウム酸化物の合成／構造解明に成功	<技術開発>	<技術>
【2/20(月)16時】元ソフトバンク社 新規事業開発担当が教える「大企業 新規事業開発の成功法則 ～誰もが体感する大企業の矛盾、フェーズ別『障壁』の突破方法～」無料オ...	<レビュー>	<レビュー>
世界初、超伝導磁束量子ビットを応用した磁場センサで神経細胞中の鉄イオン検出に成功	<技術開発>	<技術>
～単一細胞相当の分解能を持つ高精密病理検査の実現に向けた原理を確立～	<技術開発>	<技術>
理科大、256mAh/gの放電容量を持つマグネシウム二次電池の開発に成功 (1)	<技術開発>	<技術>
エッジで動作するAIモジュールを搭載したドローンで、リアルタイムでの通信鉄塔のさび検知と映像伝送に成功 | ニュース | NEDO	<技術開発>	<技術>
「先生、なんか万能細胞ができてます」「99.9％、これは何かの間違いだ…」山中伸弥教授による《iPS細胞の作製成功》はいかに実現したのか？「今日は何が起こるんだろうと毎日が楽しみでした」「20代の若者が集まるとすごい力が出るんだ」	<レビュー>	<レビュー>
DXの成功は、安全なインフラ整備から。データベースの技術者集団インサイトテクノロジーが「Insight Governor（インサイトガバナー）」を正式リリース。	<方針>,<レポート>,<技術開発>,<商品化>	<技術>,<製品サービス>
5G活用、除雪車の遠隔運転に成功　ドコモが福島・昭和で実証実験（福島民友新聞）	<利用・採用>,<技術開発>,<実験>	<技術>
浜松ホトニクス、8インチピクセルアレイディテクタの開発に成功 - 日本経済新聞	<技術開発>,<市場動向>	<技術>
5GとVRで除雪車の遠隔運転に成功、豪雪地帯の負担軽減へ：自動運転技術	<技術開発>,<目標>	<技術>
三菱マテ　新結晶構造の酸化錫　合成に成功	<技術開発>	<技術>
内製化のメリット／デメリットと成功のポイントは？：ビジネスパーソンのためのIT用語基礎解説	<レビュー>	<レビュー>
【速報】iPS細胞の分化誘導技術で、不妊治療の成功率を高める「Dioseve（ディオシーヴ）」がリアルテック・カタパルト優勝！（ICC FUKUOKA 2023）	<方針>,<技術開発>,<表彰>	<技術>
「トリュフ」の人工栽培に国内で初めて成功…海外産と香りは違う?研究者「正直、想定外のことでした」（FNNプライムオンライン）	<技術開発>,<レビュー>,<研究>	<技術>,<レビュー>
【岡山大学】一酸化窒素はDNA修飾の制御因子であることを発見 ～特異的阻害薬の開発に成功し、がんなどの疾患治療薬としての応用に期待～：山陽新聞デジタル｜さんデジ	<技術開発>,<研究>	<技術>
「効率ばかり」求める人はダメ！「無駄なこと」「寄り道する」人が結局、仕事でも成功する深すぎる納得理由（東洋経済オンライン）	<レビュー>	<レビュー>
言語AIのELYZA、JR西日本グループのDXを推進。”二刀流”でGPT/国産AIを使い分け多領域で高速DX推進。顧客対応業務の半自動化に成功。	<方針>,<技術開発>	<技術>
新着情報: メカノケミカル有機合成反応に特化した触媒の開発に成功～有機溶媒の使用量を低減する環境調和型物質生産プロセスの拡充へ～（創成研究機構化学反応創成研究拠点　教授　伊藤　肇、准教授　久保田浩司）	<技術開発>,<効果>,<生産活動>,<目標>	<技術>,<製品サービス>
水を高核偏極化する色素材料の開発に成功　～一重項励起子分裂（シングレット・フィッション）の新しい応用を提案～	<技術開発>,<提案>,<業界情報>	<技術>,<オピニオン>
Pale Blueの水推進機が地球低軌道上でのエンジン噴射・推力生成に成功	<技術開発>	<技術>
DXの成功に不可欠な3つの要件	<レビュー>	<レビュー>
ＣＯ２データ、異なるソリューション間で連携　Green x Digitalコンソーシアム、日本初の技術実証に成功	<提携>,<技術開発>	<技術>,<提携>
上の世代は学ぼうとせず、「若い社員に裁量を与えて終わり」…「成功するワケないDX」に陥らないために「絶対にやるべきこと」（現代ビジネス）	<障害>,<レビュー>	<社会>,<レビュー>
惣菜・弁当の盛付、蓋閉め工程などロボットシステム開発に成功	<技術開発>	<技術>
「水素・ホウ素」核融合に成功、核融合科研と米新興TAE - 日本経済新聞	<技術開発>,<市場動向>	<技術>
有人フライトは「成功」「空飛ぶクルマ」の実証実験　国内初「パイロット乗る有人フライト」「時速100km」「15分の飛行が可能」大阪城公園（MBSニュース）	<実験>,<レビュー>,<技術開発>	<技術>,<レビュー>
100%バナナペーパーの製品化に成功　100％フィリピンのバナナの茎のみが原料のサスティナブルな紙「BP100」を発売	<技術開発>,<商品化>	<技術>,<製品サービス>
【リスキリング成功術を解説する無料ウェビナー】学ばない社員を変えていくリスキリングの仕掛けづくり	<セミナー>,<コラム>	<イベント>,<オピニオン>
慢性期完全脊髄損傷に対するヒトiPS由来細胞移植を用いた複合治療の開発に成功－ヒトiPS由来細胞移植と肝細胞増殖因子含有スキャフォールドの併用療法－：[慶應義塾]	<技術開発>	<技術>
ドローンが“空飛ぶクレーン”に！ 国交省荒川下流事務所や大林組の現場で重量物運搬に続々と成功 | 建設ITブログ	<技術開発>	<技術>
北大ら，中性子ビームで温度可視化に成功	<技術開発>	<技術>
HPCとAIを活用した量子化学シミュレーション高速化技術を開発し、クリーンなアンモニア合成に向けた触媒候補探索期間の大幅な削減に成功 : 富士通	<技術開発>	<技術>
荏原、液体水素昇圧ポンプの開発に成功 - 日本経済新聞	<技術開発>,<市場動向>	<技術>
グラフェン・金の化学結合の様子、世界初観測に成功／原子力機構など３者 | 電気新聞ウェブサイト	<技術開発>	<技術>
Heartseed、iPS細胞を用いた心筋再生治療薬HS-001の第I/II相LAPiS試験における1例目の移植成功	<技術開発>	<技術>
まずは「個人レベル」から。組織アンラーニング成功への極意とは | Techable(テッカブル)	<コラム>	<オピニオン>
自由に動き回るタコの脳波を世界で初めて記録に成功 - バイオマーケットjp	<技術開発>	<技術>
岡山大、ヒトiPS細胞由来肢芽間葉系細胞を用いた新規軟骨細胞シートの作製に成功	<技術開発>	<技術>
【岡山大学】世界初！極性転換スイッチを利用し、鎖状インドール5量体の合成に成功！	<利用・採用>,<技術開発>	<技術>
アンリツと京セラが協業し、世界初PCI Express® 5.0の光信号伝送試験に成功 | ニュースリリース | ニュースルーム | 京セラ	<技術開発>,<商品化>	<技術>,<製品サービス>
名大、厚さ0.9nmのアモルファスシリカナノシートの合成に成功 - 日本経済新聞	<技術開発>,<市場動向>	<技術>
未利用熱を高効率にエネルギー変換、小型ORC発電システムの省エネ化に成功（スマートジャパン）	<技術開発>	<技術>
eロボティクス茨城／環境ロボティクス協会と福島県の無人航空機運行管理システムで複数のドローンの動態管理に成功	<技術開発>	<技術>
【ニュートピ！ゆるいニュース (4842P) 】 【やじうまPC Watch】核融合研、放射線出さない核融合反応に世界初成功 - PC Watch	<技術開発>	<技術>
吸って使う「見えないマスク」の開発に成功！	<技術開発>	<技術>
Sakuuが次世代電池の3Dプリントに成功	<技術開発>	<技術>
【ハートシード】心不全患者への移植成功‐他家iPS細胞由来心筋球｜薬事日報ウェブサイト		
味の素バイオファーマサービスが高機能な先天性RNAリガーゼの開発に成功	<技術開発>	<技術>
名大、負熱膨張材の微粒子化に成功　樹脂フィルムなど向け	<技術開発>	<技術>
超伝導磁束量子ビットを用いて神経細胞中の鉄イオンの検出に成功：医療技術ニュース	<技術開発>	<技術>
躁うつ行動を示す世界で初めての双極性障害モデルマウス作製に成功	<技術開発>	<技術>
ゴミ焼却発電施設でAI活用制御による長期運転に成功【日立ハイテクソリューションズ／日立造船】「先追い制御」で発電効率向上に貢献	<技術開発>,<説明>	<技術>,<レビュー>
【ジョイスティックで操縦】空飛ぶクルマの実証実験成功　実用化に期待　“公共スペースでのパイロット飛行”国内初　大阪（FNNプライムオンライン）	<実験>,<技術開発>	<技術>
下着についた尿の「におい」はアンモニア臭ではない！？  尿のにおいの調合に成功！	<レビュー>,<技術開発>	<技術>,<レビュー>
宇宙空間における放射線環境耐性の高いフェーズドアレイ無線機の開発に成功	<技術開発>	<技術>
ソフトバンクなど、光無線通信で水中ロボットのリアルタイム制御に成功	<技術開発>	<技術>
量子誤り訂正に成功したグーグル、次に挑む量子コンピューター実用化の最難関とは	<コラム>	<オピニオン>
筋ジストロフィーなどの難治性筋疾患、研究に有用なヒト骨格筋組織モデルの開発に成功	<技術開発>	<技術>
ニコン、HeartseedがiPS細胞を用いた心筋再生治療薬（HS-001）の第I/II相LAPiS試験における1例目の移植成功を発表　ニコン・セル・イノベーションが治験用のiPS細胞由来心筋細胞・心筋球を製造	<生産活動>	<製品サービス>
新着情報: 新規開発したゲルを用いて脳の神経組織の再構築に成功～将来の脳損傷の新治療法開発への貢献に期待～（医学研究院　教授　田中伸哉）	<技術開発>,<説明>	<技術>,<レビュー>
技術と経験生かすライフシフト　成功には3つの法則（NIKKEI STYLE）		
「人嫌いは成功しない」のウソ。人嫌いほど成功するものとは？	<障害>,<レビュー>	<社会>,<レビュー>
ＨＬ－ＬＨＣ実験向けＰＤアレイの開発、量産体制確立に成功	<技術開発>	<技術>
神戸大学とＮＴＴドコモなど、遠隔地からロボット手術を支援する実証実験に成功　国内初	<技術開発>	<技術>
新着情報: EUV露光の高出力化をもたらす光源プラズマ流観測に成功～「流れを操り、光を作る。」新しい概念に基づく半導体露光用EUVプラズマ光源の開発に期待～（工学研究院　准教授　富田健太郎）	<技術開発>	<技術>
【必見】1万円を100億円に変えた、非常識な成功哲学	<コラム>	<オピニオン>
3カ月の研修でIT人材を育成して派遣、成功事例テコに急成長	<政府・会談>,<業界情報>	<政策>
自社の情報発信、アピールを成功に導く4つの要素 | THE OWNER	<コラム>	<オピニオン>
超伝導の新しいメカニズム「量子液晶揺らぎによる電子対形成」の検証に成功 | e.x.press	<技術開発>	<技術>
ソニーの衛星「EYE」、宇宙で「水エンジン」の噴射に成功–Pale Blueが開発（UchuBiz）	<技術開発>	<技術>
KDDI、三菱、NECネッツアイ、冷却設備におけるティア4レベルでの安定稼働に成功	<技術開発>	<技術>
ガラス製造過程でアンモニア100%を用いる技術実証に成功【日本山村硝子ほか】1,450℃以上でソーダ石灰ガラスを溶融	<技術開発>	<技術>
超電導使った無線送電に成功　山形大工学部共同グループ（山形新聞）	<技術開発>	<技術>
なぜ日本企業のDXはうまくいかないのか？ 成功に導く3つの策をIT専門家が解説	<レビュー>	<レビュー>
ラボ培養網膜眼細胞、接続に成功 | e.x.press	<技術開発>	<技術>
もし中国が台湾侵攻に成功すれば…元米高官「米国はTSMCの半導体工場を破壊するべき」（朝鮮日報日本語版）	<コラム>,<社会事件>	<社会>,<オピニオン>
日米の研究チームが「放射性物質を使わない革新的な核融合技術」のテストに成功	<技術開発>	<技術>
血管にミニロボットを入れて外科手術を行う概念実証に成功（GIGAZINE）	<技術開発>	<技術>
社内DXとは？　推進が必要な理由や成功させるポイントを紹介	<レビュー>	<レビュー>
新規事業担当者必見--Sun Asteriskが明かす、400の共創事例から明らかになった成功の秘訣	<レビュー>	<レビュー>
⽔を⾼核偏極化する⾊素材料の開発に成功 | 研究成果 | 九州大学（KYUSHU UNIVERSITY）	<技術開発>,<研究>	<技術>
ローランド・ベルガーのパートナーが語る「変革に成功した企業のある共通点」（JBpress）	<レビュー>	<レビュー>
「同じ成功」は繰り返さない。エネルギー変革の時代に挑むニチガスのDX（JBpress）	<コラム>	<オピニオン>
【プレスリリース】量子インターネットへ向けた通信波長光源と量子メモリの長距離光ファイバ伝送による接続に成功	<商品化>,<目標>,<技術開発>	<技術>,<製品サービス>
デジタル化に活路を見出した、大企業14社の成功事例集 たゆまぬ改善で企業を躍進させる！		
東京-神戸間（約500km）で商用の5G SAを活用し遠隔地からロボット手術を支援する実証実験に成功	<技術開発>	<技術>
なぜ大手企業は「計画通りに売れない」ことを想定しないのか？　新規事業を成功させる4つのポイント	<障害>,<レビュー>	<社会>,<レビュー>
ノキアとドコモ、NTTが6G技術開発 AIの無線インターフェースへの実装に成功｜BUSINESS NETWORK	<技術開発>	<技術>
ｉＰＳ軟骨、サル同士の移植成功　拒絶反応なし、ヒトにも期待―大阪大など：時事ドットコム	<コラム>	<オピニオン>
核融合で画期的な成果、念願の「エネルギー純増」に成功	<技術開発>	<技術>
ランサム被害対応の成功と失敗 | JDIR	<レビュー>,<障害>	<社会>,<レビュー>
「空飛ぶクルマ」岡山・笠岡でも屋外有人飛行成功　倉敷のMASC、大分に続き2回目（山陽新聞デジタル）	<業界情報>	
JEITA、GreenxDigitalコンソーシアムが異なるソリューション間でのCO2データ連携の技術実証に成功 - 日本経済新聞	<技術開発>,<市場動向>	<技術>
トリュフ栽培、国内で初成功…ヨーロッパ産に匹敵する芳醇な風味	<技術開発>	<技術>
デジタルイノベーション研究の第一人者が語る、「中小企業DX」成功の勘所	<コラム>	<オピニオン>
遺伝子の光反応を実現する新しい光架橋性化合物の開発に成功 ～あらゆる分子への光反応性の付与を可能とする万能分子に期待～	<技術開発>,<見解>,<要望>	<技術>,<政策>,<オピニオン>
極微小バルブで1分子の流れの制御に成功 | 理化学研究所	<技術開発>	<技術>
鹿の角の幹細胞を移植しマウスに角を生やすことに成功。再生医療の進展につながる可能性	<技術開発>,<レビュー>	<技術>,<レビュー>
共同発表：ＡＩによる流動現象の高精度・高速な予測に成功～設計・製造における評価プロセスの加速に期待～	<技術開発>	<技術>
ラボ培養網膜眼細胞、接続に成功 | e.x.press	<技術開発>	<技術>
東大、電通大と共同で通常とは異なる性質を持つ磁性体の開発に成功 - 日本経済新聞	<技術開発>,<市場動向>	<技術>
物流の未来～社会の基盤を強くするアイデアとプラン～／同族企業の事業承継 成功の条件とは－「月刊事業構想」２０２３年４月号発売	<レビュー>,<商品化>	<製品サービス>,<レビュー>
GPT-3に匹敵するチャットAIモデル「LLaMA」をiPhoneやPixelなどのスマホで動かすことに成功	<技術開発>	<技術>
オスの皮膚細胞を卵子に変換し「オス同士の子供」を作ることに成功！	<技術開発>	<技術>
ケアマネジャーの面談業務時間、7割削減に成功！ KDDI/NICT/NEC等が高齢者向け対話AIを開発、介護モニタリング実証実験 - ロボスタ	<技術開発>,<実験>	<技術>
冷却型としては超低消費電力なマイクロ波増幅器の実証に成功 ―電波望遠鏡の受信機から量子コンピュータへの応用に向けて―｜国立天文台(NAOJ)	<技術開発>,<目標>	<技術>
超高速量子計算のための世界最速43 GHzリアルタイム量子信号測定に成功 | e.x.press	<技術開発>	<技術>
都医学研など、脊髄損傷をバイパスし麻痺した手の力の調節機能の回復に成功 (1)	<技術開発>	<技術>
創薬・バイオ研究の湘南アイパークが、オープンイノベーション拠点として成功した理由とは	<技術開発>,<レビュー>	<技術>,<レビュー>
三菱重工 | 「次世代型オイルレス冷熱ORCタービン発電機」による窒素冷熱発電に成功　ORC発電向けタービンの完全密閉型オイルレス構造を冷熱発電向けに応用	<技術開発>	<技術>
5Gの3年間は4Gの5年間に匹敵、通信事業者は5G展開の第1ラウンドを成功裏に完了	<コラム>	<オピニオン>
米研究所「太陽の力を再現」に成功も、「核融合発電」の実用化に壁　実現は「数十年先」か〈AERA〉（AERA dot.）	<コラム>	<オピニオン>
これだけは絶対にやってはいけない　稲盛和夫が断言した｢成功しない人｣に共通するたった1つのこと	<コラム>	<オピニオン>
小売業で「リスキリング」はどう進める？　DXを成功に導く8つのポイント（ITmedia ビジネスオンライン）	<方針>,<レビュー>	<レビュー>
愛媛大、高濃度トレハロースを用いて3次元培養真皮シートの作成に成功 (1)	<技術開発>,<資金>	<技術>
【弘前大学】天候を感知し養殖用機械を遠隔操作できる自然エネルギー利用システムを開発 -- 青森県鰺ヶ沢町のアユ養殖場で実証実験に成功	<技術開発>	<技術>
シンチレーション光の波長情報による放射線粒子の識別に成功 ～高精度な放射線検出の可能性～ | TSUKUBA JOURNAL - テクノロジー・材料	<技術開発>,<レビュー>	<技術>,<レビュー>
オープンイノベーションを成功に導く技術法務のススメ 経済産業調査会　知的財産研修会（セミナー）	<イベント>,<市場動向>,<調査>	<イベント>
ごみ焼却設備の発電ロス最小　ＡＩ制御による長期運転に成功　日立造船と日立ハイテク | 電波新聞デジタル	<技術開発>	<技術>
ついに試走開始､フランス｢新型TGV｣成功する条件		
「小売業の成功の鍵はAI活用とデジタルツイン」NVIDIAが豊富な事例を紹介	<紹介>,<説明>	<レビュー>
【2/14(火)16時】「ビジネスコンテストを成功に導く NTTデータの事業デザイン～「ハート思考」から始める事業開発～」無料オンラインセミナーを開催	<技術開発>,<サービス開始>,<セミナー>	<イベント>,<技術>,<製品サービス>
成功するスタートアップほど｢シンプル｣に稼ぐ		
高度化する無人化施工、ローカル5Gで建機自動走行と4K映像送受信に成功 ニュースイッチ by 日刊工業新聞社	<技術開発>	<技術>
投資成功で退職し“FIRE”するも1年で再就職…約2000万円の資産減で決意?30代男性を襲った“落とし穴”（FNNプライムオンライン）	<方針>,<レビュー>,<社会事件>	<社会>,<レビュー>
やまびこ　ハイブリッドエンジンＰＵ搭載のドローン、テスト飛行に成功	<技術開発>	<技術>
「ミッション・ドリブン」な会社こそ成功する。うまくいかない組織に足りないことは？（ライフハッカー・ジャパン）	<レビュー>,<障害>	<社会>,<レビュー>
オルツ、日本発大規模言語処理モデル「LHTM-2」の開発および個性化に成功	<技術開発>	<技術>
就農前のスマート農業導入で失敗回避、珍品種栽培成功と思わぬ副産物	<見解>,<技術開発>	<技術>,<オピニオン>
【プレスリリース】マクロライド系抗生物質アジスロマイシンのオートファジー阻害活性における分子機構の解明に成功 ～ 今後のアジスロマイシンのがん治療応用に期待 ～ | 東京医科大学	<商品化>,<技術開発>	<技術>,<製品サービス>
「頑張らなくてもネットでとてつもなく売れる人」に共通する、たった1つの成功法則（ダイヤモンド・オンライン）		
歯科治療で発生する飛沫・エアロゾルの可視化に成功 ―より清潔で安心な歯科医療環境の技術開発へ期待―	<技術開発>	<技術>
情通機構と住友電工が世界記録、19マルチコア光ファイバーで毎秒1.7ペタビットの伝送に成功した意義（ニュースイッチ）	<技術開発>	<技術>
ウェイブガイドの評価手法の開発に成功	<技術開発>	<技術>
JSTとRICOS、AIによる流動現象の高精度・高速な予測に成功 - 日本経済新聞	<技術開発>,<市場動向>	<技術>
ハイケムなど3者　CO2由来のPX製造・単離に成功 – 日刊ケミカルニュース	<技術開発>	<技術>
AI画像解析ウェビナー 成功するDX推進のキーポイントとは？小売・流通・物流業界別の事例をご紹介	<レビュー>,<紹介>	<レビュー>
【3/28(火)16時】「リコー新規事業担当者が語る「大企業×新規事業」成功のロードマップ  〜構想をカタチにする事業開発の実践論〜」無料オンラインセミナーを開催	<コラム>,<レポート>,<セミナー>	<イベント>,<オピニオン>
デジタルシフトに成功したＳＵＢＡＲＵのワークスタイルはどう変わったのか | JDIR	<レビュー>	<レビュー>
昆虫の「全脳マッピング」にはじめて成功！	<技術開発>	<技術>
Techouse、日経産業新聞フォーラム「人的資本経営を成功に導く人事DX～戦略人事を通して企業変革へ～」に登壇	<セミナー>	<イベント>
UX DAYS TOKYO 2023 [思考] 成功の9割は、マインドセットから3月31日(金)〜4月2日(日)開催		
VC直伝、読みやすいピッチデックの作り方。景気後退期でも資金調達の成功確率を高める3つのポイント	<方針>,<レビュー>	<レビュー>
ＬＥＤ照明に塗布…ウイルス不活化に成功　信大や松本市の企業などが共同開発【長野】（テレビ信州）	<技術開発>	<技術>
国立がん研究センター、極めて複雑な合成医薬分子に短寿命核種を導入　抗がん剤エリブリンの炭素11による標識に成功	<組織変更>,<利用・採用>	<技術>
京都大、室温で高温超伝導モーターの運転に成功	<技術開発>	<技術>
D2Cブランドの成功事例16選！日本で成果を出すための施策も紹介	<紹介>,<レポート>,<施策>	<レビュー>
「森永ラムネ」が“大人の必需品”になったのはなぜ？「ぶどう糖」の思わぬ効果をきっかけに戦略を変えて大成功！（ウォーカープラス）	<レビュー>	<レビュー>
サービスロボットとChatGPT連動に成功、世界に向けて β テストを開始　OrionStar Robotics	<技術開発>,<目標>,<実験>	<技術>
タンニンのタンパク質凝集モデルの作成に成功	<技術開発>	<技術>
世界初、自由に動いているタコの脳波を記録することに成功。未知の脳波を発見	<技術開発>,<研究>	<技術>
「SaCas9」によるDNA切断の動画撮影に成功　安全なゲノム編集ツール開発へ (1)	<技術開発>	<技術>
日立造船と日立ハイテクがごみ焼却発電施設でAI制御による長期運転に成功	<技術開発>	<技術>
【事例】全社的なモニタリングコストを最適化に成功し、事業拡大を加速させるサイバーエージェント	<説明>,<業界情報>,<方針>	<レビュー>
新着情報: 二つの触媒の協働作用により光エネルギーから医薬品骨格を構築〜安価なギ酸誘導体と安定な芳香環を光照射下反応させてα-アミノ酸の合成に成功〜（創成研究機構化学反応創成研究拠点　特任准教授　美多　剛）	<技術開発>	<技術>
深層学習を用いたプロフィール画像解析により、業者検知システムの更なる強化に成功。マッチングアプリ「CoupLink」	<技術開発>	<技術>
ドコモ東北支社とNTT Com、5Gを活用した除雪車両の遠隔運転に成功｜BUSINESS NETWORK	<技術開発>	<技術>
ナガセケムテックス、バイオ由来 高バイオマス度の高吸水性ポリマーの開発に成功	<技術開発>	<技術>
世界初の内視鏡下パルス電場腫瘍摘除術 中国・西安で実施に成功	<技術開発>	<技術>
自信がなくても勇気を出して行動すれば、キャリアの成功に近づける（DIAMOND ハーバード・ビジネス・レビュー）	<コラム>	<オピニオン>
中国企業開発の自律型航空機、日本で初の有人飛行試験に成功		
インターステラテクノロジズの超小型人工衛星用ロケット「ZERO」衛星フェアリングの分離放てき試験に成功		
DX成功の鍵を握る技術・ソリューションとは？重視度ランキングトップ15	<技術開発>,<レビュー>,<レポート>	<技術>,<レビュー>
K-POP×バーチャルは一大ムーブメントに？　「MAVE:」はaespaの成功を踏まえ“現実と仮想世界の垣根”を超えられるか（リアルサウンド）	<前提>,<業界情報>,<社会統計>,<レビュー>	<社会>,<レビュー>
共同発表：耐熱性・耐薬品性に優れるスーパーエンジニアリングプラスチックのリサイクル技術を開発～ポリエーテルエーテルケトンのモノマー単位への解重合に成功～	<技術開発>	<技術>
“隠せない時代”の企業成長に必要な「人的資本経営」成功のポイント | THE OWNER	<レビュー>	<レビュー>
約6割が営業現場のDXは「進んでいない」一方、DX推進企業からは「利益率の向上」「属人化から脱却に成功」などの声	<業界情報>,<障害>,<意見>	<社会>,<オピニオン>
「心理的安全性」とは何か？Googleが注目した成功するチームの共通点（幻冬舎ゴールドオンライン）	<レビュー>,<技術動向>	<技術>,<レビュー>,<オピニオン>
双極性障害の躁・うつの両方の症状を示す世界初の動物モデルの作製に成功	<障害>,<技術開発>	<技術>,<社会>
メディカロイドや神戸大学、手術ロボ遠隔操作実験に成功	<技術開発>	<技術>
新着情報: 世界最長のアントラセンオリゴマーの詳細な調査に成功～新たな設計指針の獲得により次世代型分子スイッチの開発に期待～（理学研究院　准教授　石垣侑祐）	<技術開発>,<見解>,<要望>	<技術>,<政策>,<オピニオン>
人生はロングゲーム　成功を引き寄せる長期の戦略とは（NIKKEI STYLE）	<戦略>,<コラム>	<オピニオン>
サクーが完全機能型高性能パターン電池の3Dプリントに成功したと発表：時事ドットコム	<技術開発>	<技術>
ＳＯＭＰＯひまわり生命が提供する お客さまの健康を応援する「インシュアヘルス」商品の累計販売件数100万件突破～お客さまが禁煙や健康状態の改善に成功～	<技術提供>,<商品化>,<技術開発>	<技術>,<製品サービス>,<提携>
Novartis社の2022年度決算──減収減益、期待のB因子阻害薬の第3相が成功	<業績>	
副業でブランド設立＆売却　元アナウンサーのAIスタートアップ社長に聞くM&A成功秘話 | THE OWNER	<譲渡・買収>,<コラム>	<オピニオン>,<提携>
組織改革を成功させるには？基本のフレームワークとポイントを解説	<レビュー>	<レビュー>
MIT、シリコンウエハー上に単原子分の厚みの材料形成に成功——次世代プロセッサー向け技術｜fabcross	<技術開発>	<技術>
人生成功の道：人生、3度しかないチャンスを「遠慮」する日本人	<コラム>	<オピニオン>
停滞気味のシェアサイクル事業が静岡市で成功を収めている理由｜@DIME アットダイム	<レビュー>	<レビュー>
ICT教育を成功させるコツ　子どもの「生きる力」を育み、先生の校務負担を減らすには？　有識者に聞く	<技術開発>,<レビュー>	<技術>,<レビュー>
【バイオデザイン学会】治療機器で成功事例創出を‐ベンチャーめぐり議論｜薬事日報ウェブサイト	<イベント>,<政府・会談>	<イベント>,<政策>
福島県の無人航空機運行管理システム（ＵＴＭ）で複数のドローンの動態管理に成功！	<技術開発>	<技術>
【第2回】物流DX（デジタル・トランスフォーメーション）を成功に導くヒント～会社の成長に必要不可欠なDX人材を育成するためのポイント～	<イベント>,<レビュー>	<イベント>,<レビュー>
量研機構など、てんかん向けの新規オンデマンド治療法を動物実験で実証成功 (1)		
「成功パターン公開で金融業界のAI活用レベルアップ」金融データ活用推進協会 佐藤理事	<技術開発>	<技術>
ジャイロトロンを用いた金属磁性薄膜のサブTHz磁化ダイナミクス評価に成功―テラヘルツスピンデバイスへ向けて―	<技術開発>,<目標>	<技術>
東北大、原子種個々の運動速度を測定する「スピードガン」の開発に成功	<技術開発>	<技術>
ダイヤモンド半導体　界面の欠陥低減　立体原子配列解明に成功　近大、奈良先端大など | 電波新聞デジタル	<技術開発>,<効果>	<技術>
ソフトバンクと東京海洋大、水中光無線通信で狭隘空間を移動する水中ロボットのリアルタイム制御に成功 | Biz/Zine	<技術開発>	<技術>
有人飛行に成功した空飛ぶクルマ「SD-03」の実機と透視図が、「スケスケ展」で初の一般公開！	<イベント>	<イベント>
ヒトiPS細胞由来肢芽間葉系細胞を用いた新規軟骨細胞シートの作製に成功 - 国立大学法人 岡山大学	<技術開発>	<技術>
三菱マテと東工大、新結晶構造の酸化スズ合成に成功　可視光を幅広く吸収	<技術開発>,<譲渡・買収>	<技術>,<提携>
中国テック事情：バブル化する「チャットGPTもどき」は成功するか？	<レビュー>	<レビュー>
「夢なき者に成功なし」過去最大損失から2年でV字回復 | Forbes JAPAN 公式サイト（フォーブス ジャパン）	<業界情報>	
ウォーレン・バフェットから学ぶ、人間関係の築き方。人生の成功者と失敗者を分けるものとは？（ライフハッカー・ジャパン）	<レビュー>	<レビュー>
光の螺旋性で結晶のキラリティー制御に成功	<技術開発>	<技術>
福原愛さんが中国でメタバース業界に参入　爆売れで起業家として成功へ（東スポWEB）	<業界情報>,<目標>	
「30代で成功した人」の共通点、“人生の転機”をどう乗り越えるか？	<レビュー>	<レビュー>
腸での「呼吸」にブタで成功　重度呼吸不全の新しい治療法開発へ　名大ら |  財経新聞	<技術開発>,<目標>	<技術>
名古屋大、アモルファスシリカナノシートの合成に成功　究極の薄さ、厚さ0.9ナノメートル | 電波新聞デジタル	<技術開発>	<技術>
桐蔭学園の高大連携の挑戦！ ペロブスカイト太陽電池で電車模型を走らせることに成功。	<技術開発>	<技術>
オフィス学の碩学が科学的研究を基に伝授！ハイブリッドワーク成功の秘訣（JBpress）		
東大・岡山大・弘前大、「量子液晶揺らぎによる電子対形成」の検証に成功 - 日本経済新聞	<技術開発>,<市場動向>	<技術>
基生研ら，赤色光で線虫の行動コントロールに成功 | OPTRONICS ONLINE　オプトロニクスオンライン	<技術開発>	<技術>
自動撮影によって赤とんぼの定量的調査に成功 —福島県の営農再開水田等で実証—｜2022年度｜国立環境研究所	<技術開発>,<実験>	<技術>
セガXDが説明する、社内外での共創を最大化させ事業を成功に導くゲーミフィケーションの取り組み	<紹介>,<レビュー>	<レビュー>
AIアバター「AIひろゆき」誕生！自動でどんな質問にも回答する「AIアバター化」にChatGPT等のAI技術で成功 - ロボスタ	<サービス開始>,<技術開発>	<技術>,<製品サービス>
北海道大学発宇宙ベンチャー、Letara(株)が1.2億円の資金調達に成功	<資金>	
【漫画】子の自立は「朝の起床」で9割決まる！成功の鍵は「遅刻でも起こさぬ」覚悟と4つのコツ（with online）	<レビュー>	<レビュー>
Appleの「若者ターゲット」戦略は成功している〜CIRP調査	<調査>	
世界初、10空間多重光信号の空間モード多重増幅中継伝送に成功	<技術開発>	<技術>
～従来の10倍以上の長距離・大容量光ネットワークの実現へ貢献～	<技術開発>,<説明>	<技術>,<レビュー>
アンリツと京セラがPCIe5.0伝送試験成功　信号損失低減、DC省電化に期待 | 電波新聞デジタル	<実験>,<政府>,<技術開発>,<効果>	<技術>,<政策>
誰もできなかった「フクロウの繫殖」…見事成功した、驚くほどシンプルな方法【脳科学者・茂木健一郎が解説】（幻冬舎ゴールドオンライン）	<障害>,<説明>	<社会>,<レビュー>
世界最大級のスタートアップ登竜門「XTC」が重視する成功への条件		
大成功を収めている人たちに共通する「重要な習慣」		
eロボティクス茨城、霞ヶ浦で無人水上飛行艇を使った物流飛行の実証試験に成功	<技術開発>	<技術>
阪大、iPSから膝関節軟骨　免疫反応抑えサルで再生成功		
携帯の電波なしも遠隔操作に成功　弘前大学研究グループ　（青森県）（青森放送）	<技術開発>,<研究>	<技術>
不妊治療を成功させるには？睡眠、喫煙、サプリメントなど見直すべき5つの生活習慣【医師が回答！ 30代・40代の不妊治療悩み＆疑問】（＠BAILA）	<技術開発>,<レビュー>	<技術>,<レビュー>
iPSで膝軟骨、サルで移植成功　大阪大学（写真=共同） - 日本経済新聞	<市場動向>	
低軌道通信衛星コンステレーションに向けた耐放射線Ka帯無線機の開発に成功	<技術開発>	<技術>
NTTドコモとNEC、AWSを活用したハイブリッドクラウド構成の5GCの冗長設計とエッジ向け5Gユーザー通信装置の基本動作に成功	<技術開発>	<技術>
放射線治療の効果　正確な予測に成功　世界初　（青森県）（青森放送）	<効果>,<技術開発>	<技術>
“世界三大珍味のトリュフ” 国内で初の人工栽培成功 専門家「流通しているものにひけは取らない」（ABEMA TIMES）		
Yakult1000だけじゃない！ヤクルトの売上4割超を稼ぐ海外事業「成功の秘密」	<レビュー>	<レビュー>
スペースX、スペインの通信衛星「Amazonas Nexus」の打ち上げに成功（sorae 宇宙へのポータルサイト）	<技術開発>	<技術>
1300年で成功者は2人だけ、命がけの修行を達成した住職　塩沼亮潤大阿闍梨から学ぶ、不安や「とらわれ」との向き合い方	<社会統計>,<コラム>	<社会>,<オピニオン>
イーロン・マスク、スティーブ・ジョブズ…時代を切り拓く成功者たちが持つ「野心」の正体【脳科学者・茂木健一郎が解説】（幻冬舎ゴールドオンライン）	<レビュー>	<レビュー>
空飛ぶクルマ有人飛行、岡山で成功 - 日本経済新聞	<技術開発>,<市場動向>	<技術>
「えこひいき」が組織の成功に役立つとの研究が発表される	<技術開発>,<研究>	<技術>
ドイツのスタートアップ、欧州で初の公道での遠隔運転による無人走行に成功(ドイツ) | ビジネス短信 ―ジェトロの海外ニュース		
インターステラ、次期ロケット「ZERO」のフェアリング分離試験に成功（UchuBiz）	<技術開発>	<技術>
これだけは絶対にやってはいけない…稲盛和夫氏が断言した｢成功しない人｣に共通するたった1つのこと シリコンバレーの起業家が｢盛和塾｣で学んだこと	<コラム>	<オピニオン>
リスクや売り上げの壁を越えて「社員ゼロ」で成功しよう『社員ゼロで1億円を生み出す　最強の稼ぎ方』2月15日発売	<コラム>,<商品化>	<製品サービス>,<オピニオン>
Python OpenPyXLで【第2軸付き】グラフ作成に成功!?｜スイスイ ヒュ ｜note	<技術開発>,<レビュー>	<技術>,<レビュー>
DX成功へ押さえておきたい「75の心得」、推進体制や人材育成だけでは不十分	<レビュー>	<レビュー>
ExCELLSら，光るクマムシの作出に成功	<技術開発>	<技術>
耳かき一杯の大量作製に成功 つくばの研究室生まれのナノ粒子	<技術開発>	<技術>
開発部門リーダー必見！5つの成功事例に学ぶ、見える化から始める「コストの最適化」	<技術開発>	<技術>
中国企業開発の自律型航空機、日本で初の有人飛行試験に成功		
フェラーリCEO｢テスラの成功は業界の目を覚まさせた｣…高級自動車メーカーも続々とEVへ進出	<海外展開>	
一酸化炭素などの「火災ガス中毒」を解毒できる化合物の開発に成功！	<技術開発>	<技術>
山陰合同銀行「再エネ電気事業」は成功する？ ノウハウゼロでも“本気”で新規参入する理由（ビジネス＋IT）	<レビュー>,<業界情報>	<レビュー>
産総研がPEEKのモノマー単位への分解に成功、回収モノマーは高分子の合成に使用可能	<技術開発>,<レビュー>	<技術>,<レビュー>
相次ぐロケット打ち上げ失敗、次なる成功の鍵握る素早い原因究明と復帰	<レビュー>,<障害>,<芸能>	<社会>,<レビュー>
鹿島、光ファイバでダム堤体コンクリートのひずみ挙動検知に成功	<技術開発>	<技術>
人材データの整備を約50％工数削減し、マネジメント精度向上に成功した方法とは	<技術開発>,<レビュー>	<技術>,<レビュー>
クリングル---ストップ高、慢性期完全脊髄損傷の複合治療に世界で初めて成功	<技術開発>	<技術>
名大、低コストで環境に優しい新たな負熱膨張材料の微粒子化に成功	<技術開発>	<技術>
『金融DX、銀行は生き残れるのか』の著者が語る金融DX成功の鍵 | JDIR	<コラム>	<オピニオン>
問い合わせ件数が1.3倍に！ Webサイトリニューアル成功の秘訣は「会社は何者か？」の議論【1週間まとめ】 - 3/11～3/17のWeb担の記事まとめ	<市場データ>,<政府・会談>,<レビュー>	<政策>,<レビュー>
スペースX、スターリンク衛星の打ち上げに成功　総数は4053機に（sorae 宇宙へのポータルサイト）	<技術開発>	<技術>
AI操縦の戦闘機、合計17時間を超える飛行に成功--模擬空中戦も	<技術開発>	<技術>
AIボイスで音声認証を回避して、銀行口座へのアクセスに成功 - トピックス｜Infoseekニュース	<技術開発>	<技術>
インフレが問う貯金神話　デフレの成功足かせ - 日本経済新聞	<コラム>,<市場動向>	<オピニオン>
身分証で顧客を確認。「eKYC」を導入した、6社の成功事例に見る“気になる導入効果”	<技術開発>,<調査>,<見解>,<効果>	<技術>,<オピニオン>
ミニワームホール作成に成功？ カリフォルニア工科大学物理学者らが論文発表（ギズモード・ジャパン）	<技術開発>,<レビュー>	<技術>,<レビュー>
中国がゴビ砂漠で見せつけたロケットの成功　軍と民が一体で「宇宙強国」へ【経済記者が見た中国】	<技術開発>,<目標>	<技術>
諏訪の技術集結　小型ロケット打ち上げ成功【長野】（テレビ信州）	<イベント>	<イベント>
「空飛ぶクルマ」有人飛行に成功　新居浜で四国初実験　高さ8メートル、10分間（愛媛）（愛媛新聞ONLINE）	<実験>	<技術>
ガートナージャパン、日本企業がデータとアナリティクスで成功するために欠かせない役割を発表 | Biz/Zine	<レビュー>	<レビュー>
【特別対談：桑原良和×鈴木康弘】顧客のEC事業成功を伴走支援、ともに課題解決を試みるパートナーとしての役割目指す	<支援>,<方針>,<目標>	
ニッピ、HeartseedがiMatrix-221を使用した心筋再生治療薬HS-001の第I/II相治験における移植に成功	<技術開発>	<技術>
横浜国立大学などが2光子の長距離伝送に成功、量子インターネット実現へ一歩	<技術開発>	<技術>
NTT Com、5Gで救急現場の映像・心電図を病院にリアルタイム伝送する実証に成功｜BUSINESS NETWORK	<技術開発>	<技術>
エッジAIで注目の新興企業、事業縮小も資金調達に成功（EE Times Japan）	<資金>	
＜AIを活用した韓国ECビジネスの成功事例＞韓国最大手AIソリューション会社が語る「EC会社のCVRを2倍にしたAIチャットWEB接客とは？」（無料オンラインセミナー開催/4月...	<技術開発>,,<レビュー>,<イベント>	<イベント>,<技術>,<レビュー>
国内初、自動で体重管理ができる「スマートバスマット」ユーザー数が販売開始から4カ月で10,000人を達成、1カ月で平均0.8kgのダイエットに成功	<業績>,<市場データ>,<技術開発>	<技術>
「SaCas9」によるDNA切断の動画撮影に成功　安全なゲノム編集ツール開発へ - トピックス｜Infoseekニュース	<技術開発>	<技術>
ゴールドウイン、「ザ・ノース・フェイス」が湘南国際マラソンで成功させた環境負荷低減フォーマットで「せとだレモンマラソン」をサポート――紙コップなどを全廃、コース上に給水タンク・給水ジャグ設置	<支援>,<組織>,<設備投資>	
成功した金融AIノウハウ12を余さず開示『金融AI成功パターン』	<情報公開>	
“サメ肌ジェット”が試験飛行に成功　燃費向上も（テレビ朝日系（ANN））	<技術開発>	<技術>
海洋微生物の活性は深海ほど抑制されている〜高水圧下での微生物活性測定に成功〜 | TSUKUBA JOURNAL - 生物・環境	<技術開発>	<技術>
大阪公立大など、有機EL「再結合」過程観測に成功　発光効率の低下要因究明へ	<技術開発>,<目標>	<技術>
道路に敷設した光ファイバで通行車両のデータ取得に成功…プライバシー侵害なく測定を可能に | レスポンス（Response.jp）	<技術開発>,<レビュー>	<技術>,<レビュー>
【50代で－9kg減量に成功した栄養士が指南】糖質と上手につき合うための「6つのポイント」（ヨガジャーナルオンライン）	<レビュー>	<レビュー>
SpaceXの新型ロケット「Starship」、初回打ち上げ成功率は「5割」とイーロンマスク氏（UchuBiz）	<市場データ>,<社会統計>	<社会>
鹿児島ロケット打ち上げ失敗　点火成功も想定外のタイミングでパラシュート開く（ＫＹＴ鹿児島読売テレビ）	<レビュー>,<障害>	<社会>,<レビュー>
V2Xシステム普及に向け協業開始【日産自動車／日立ビルシステム】外部給電でのエレベーター稼働実験で10時間連続稼働成功	<目標>,<提携>,<技術開発>	<技術>,<提携>
EUの対中国「デリスク」路線は成功するのか？	<レビュー>	<レビュー>
【3/7(火)16時】クニエの新規事業コンサルタントが教える 「サブスク事業 成功の方程式」無料オンラインセミナーを開催	<コラム>,<セミナー>	<イベント>,<オピニオン>
シナジー効果とは？　意味や使い方、M＆Aの成功例などを紹介！ | THE OWNER	<効果>,<レビュー>,<紹介>	<レビュー>
越境とリスキリングはセット　成功する具体的方法とは（NIKKEI STYLE）	<レビュー>	<レビュー>
スカイツリーと地上可搬局で暗号鍵共有技術検証に成功、NICTなど光伝送実証・衛星通信の高秘匿化に一歩 | 電波新聞デジタル		
金融AI成功パターン、学習データの準備は収集から5ステップ	<コラム>	<オピニオン>
まるで錬金術！ ブルー・オリジンが月のレゴリスから太陽電池を造り出すことに成功	<技術開発>	<技術>
売上伸び悩みを解消！D2Cビジネスの成功戦略～化粧品・健康食品分野で月商1,000万円を超える販売手法～｜無料オンラインセミナー	<技術開発>,<戦略>,<業界情報>,<市場データ>,<レビュー>,<商品化>,<セミナー>	<イベント>,<技術>,<製品サービス>,<レビュー>
【日本】KDDI、三菱重工、NECネッツエスアイ、サーバー冷却消費電力の94%削減に成功。液浸冷却 | Sustainable Japan | 世界のサステナビリティ・ESG投資・SDGs	<投資>,<社会問題>	<社会>
動物の「逃げる方向に複数の好みの方向がある」現象、長崎大学が理論的説明に成功		
インドの新型ロケット「SSLV」打ち上げ成功、小型衛星打ち上げ市場に新星（2023年3月10日）｜BIGLOBEニュース		
核融合科学研究所・総合研究大学院大・京大など、数理最適化の手法を応用することで高精度の数理モデルを構築することに成功 - 日本経済新聞	<技術開発>,<市場動向>	<技術>
ジャイロトロンを用いた金属磁性薄膜のサブTHz磁化ダイナミクス評価に成功 ―テラヘルツスピンデバイスへ向けて―	<技術開発>,<目標>	<技術>
卒業生へのメッセージは「成功するより没落しよう。ニコニコと没落しよう。」令和4年度 バンタン卒業式 米イェール大学助教授・経済学者の成田悠輔氏 登壇	<コラム>,<生活>,<セミナー>	<イベント>,<オピニオン>
超伝導の新しいメカニズム「量子液晶揺らぎによる電子対形成」の検証に成功 - 国立大学法人 岡山大学	<技術開発>	<技術>
ライブエンタメ、都市開発、サウナ...体験型マーケティングの最新トレンドや成功事例を学ぶ「BACKSTAGE 2023」レポート（FINDERS）	<コラム>,<情報公開>,<レポート>	<オピニオン>
NTT、空間モード多重増幅中継伝送に成功　10倍以上の長距離化実現 | 電波新聞デジタル	<技術開発>	<技術>
米アレボ、炭素繊維自転車の製造成功と発表 - NNA ASIA・ベトナム・製造	<生産活動>	<製品サービス>
｢無駄なこと｣｢寄り道する｣人が仕事も成功する訳	<レビュー>	<レビュー>
人の成功体験を聞き、自分で試して実感し、満足して継続購入　Yakult1000のヒットに見る、「コトからモノ」への消費スタイル	<利用・採用>,<見解>	<技術>,<オピニオン>
フジテレビとKDDI、5G SAで東京マラソンを生中継--番組制作の実証に成功	<技術開発>	<技術>
ミドルシニアも奮闘！　5人の転職成功記　長年のスキルが生きる	<レポート>	
人材獲得難のなかで注目のリファーラル採用を倍増させた成功体験をランスタッド人事担当が伝授ビズリーチ、ハーモスと共同のウェビナーで		
高周波数帯の有効活用に向けた一歩。28GHz帯を使った遮蔽物がある中での分散MIMO実証実験に世界で初めて成功、NTTら3社	<目標>,<技術開発>,<提携>	<技術>,<提携>
ガン患者の苦痛を和らげる全く新しいステント（管状医療器具）開発に成功：[慶應義塾]	<技術開発>	<技術>
核融合研、重水素でプラズマ断熱層の高性能化成功　核融合発電へ一歩		
NTTドコモと慶大、5G高信頼低遅延通信を経由し、ヒトの手を動かして感じ取れる手応えをロボット上で再現する実証実験に成功	<技術開発>	<技術>
リグニン誘導体からアクリル樹脂の開発に成功	<技術開発>	<技術>
老化の「促進と逆転」の両方をマウスで制御することに成功！	<技術開発>	<技術>
新原理グラフェントランジスタによる高速・高感度テラヘルツ波の検出に成功　次世代6G＆7G超高速無線通信の実現に明るい光	<技術開発>,<研究>	<技術>
新着情報: 常圧220℃でCO2からのアルコール電解合成に初めて成功～電解セル技術のゼロカーボン社会への貢献に期待～（工学研究院　教授　菊地隆司）	<技術開発>,<説明>	<技術>,<レビュー>
リスキリングに関するアンケートレポート【vol.2：成功者の深堀り】：フリーランス・副業・複業人材の41.7%がリスキリングで「収入や仕事の依頼が増えた」と回答。一番人気は「データ分析・統計分析」	<情報公開>,<レポート>,<背景>,<業界情報>,<研究>	<技術>
岸田総理の「ベタ降り」で予算案も年度内成立か　「大成功」と皮肉の須田慎一郎 - トピックス｜Infoseekニュース	<レビュー>	<レビュー>
胃低分化腺癌を検出する病理AIの開発に成功	<技術開発>	<技術>
国産白トリュフの人工発生に成功 | 科学新聞 The Science News		
共同発表：世界初、超伝導磁束量子ビットを応用した磁場センサーで神経細胞中の鉄イオン検出に成功～単一細胞相当の分解能を持つ高精密病理検査の実現に向けた原理を確立～	<技術開発>	<技術>
9割の輸送ルートのパレット化に成功	<技術開発>	<技術>
スペースX、2日連続で打ち上げ成功　スターリンク衛星と小型衛星放出システムを軌道へ投入（sorae 宇宙へのポータルサイト）	<技術開発>,<商品化>,<利用・採用>	<技術>,<製品サービス>
「CNET Japan Live 2023」に代表 田村 穂が登壇　組織戦略とカスタマーサクセス(顧客の成功)の取り組みを紹介	<紹介>,<レビュー>,<戦略>	<レビュー>
消費者に届く インフルエンサーマーケティング成功の法則　Twitter/Instagram│PLAN-B×コムニコ共催セミナー	<セミナー>	<イベント>
ビジネスに貢献し経営戦略を成功に導く法務部門への挑戦 | JDIR	<コラム>	<オピニオン>
顔の骨も「3Dプリンター」で作る時代…韓国チーム、損傷部位の移植に成功	<技術開発>	<技術>
インドのアダニ、調達成功でひとまず峠越え　長期戦へ（写真=ロイター）	<目標>	
五島市で「ほうき星」撮影成功…ZTF彗星が2月1日に地球に最接近！（KTNテレビ長崎）		
グーグルが「量子誤り訂正」に成功、量子コンピューター実用化に1歩近づく	<技術開発>	<技術>
【リーダーや経営者の孤独】孤独を極める経営者が成功する！本質的にトップや社長業は孤独…誰にも頼れずしんどい、人間不信やうつを打破（経営者の孤独力を鍛える脳覚醒）	<コラム>	<オピニオン>
就航元年の「トキエア」　 “空の旅”で 一大プロジェクト   成功のカギは “付加価値”【新潟発】（FNNプライムオンライン）	<レビュー>	<レビュー>
ウィル・スミスが11歳で悟った成功哲学～膨大な仕事や高すぎる目標を楽々とクリアする方法 （滝川徹 時短コンサルタント）（シェアーズカフェ・オンライン）	<レビュー>	<レビュー>
史上初、レーザーで落雷を誘導する「レーザー誘雷技術」の実証実験が成功 | 知財図鑑		
神戸で遠隔操作…500キロ離れた東京の手術に成功　都道府県またぎ全国初「ロボット手術」5Gで　神戸大（関西テレビ）	<技術開発>	<技術>
脳傷害後の神経再生を促す超分子バイオマテリアルの開発に成功｜2022年度のニュース一覧｜同志社大学	<技術開発>	<技術>
九州初　ｉＰＳ細胞使った心臓病手術に成功　九大病院が発表　患者は１４日に退院（TNCテレビ西日本）	<技術開発>	<技術>
NEDO　Cdフリー量子ドット、パターニングに成功 – 日刊ケミカルニュース	<技術開発>	<技術>
ガス成分の直接可視化に成功	<技術開発>	<技術>
水素燃焼でアルミ形材熱処理／ＬＩＸＩＬが世界初成功 | 日刊鉄鋼新聞 Japan Metal Daily	<技術開発>	<技術>
「聞く耳を持つ」人だけが、成功を手に入れられる理由	<レビュー>	<レビュー>
蒸気プラズマによる金属炭化物のドライエッチングに成功 ～シリコン半導体集積回路材料の最先端微細加工技術を実現～	<技術開発>	<技術>
プレスリリース - クマムシゲノム由来のDNA配列を用いて、光るクマムシの作出に成功 ー水のない生命の仕組みの解明を目指してー	<商品化>,<技術開発>,<時制.未来>	<技術>,<製品サービス>
産総研：CIS系太陽電池材料で高効率な水素生成に成功	<技術開発>	<技術>
ビジネス成功のカギは「仮説」にあり。“より信憑性の高い”仮説が見つかる3ステップ（幻冬舎ゴールドオンライン）	<コラム>	<オピニオン>
ポリマーの構造を精密に制御 化学変換で様々な機能をもつスマートポリマー材料の開発に成功！―反応を繰り返すたびに付加価値が高まる― | 大阪府立大学	<技術開発>	<技術>
近未来テクノロジー見聞録(301) ダイエットを長期的な成功に導くバイオマーカーをスタンフォード大が発見！	<技術開発>,<研究>	<技術>
菊水化学　大幅反発、ジオポリマー技術応用の塗材開発に成功 |  財経新聞	<株式概況>,<技術開発>	<技術>
ガリウムヒ素ナノワイヤ、2インチシリコンウエハーに7億本集積　北大が成功	<技術開発>	<技術>
インテグリカルチャー、フォアグラ細胞培養に成功 - 化学工業日報 電子版	<技術開発>	<技術>
ドコモら、遠隔地からロボット手術を支援する実証実験に成功――東京・神戸間で商用5G SAを活用	<技術開発>,<利用・採用>	<技術>
水素燃焼によるアルミ形材のエージング処理を前橋工場の生産設備で成功	<技術開発>	<技術>
【50㎏の減量に成功した料理研究家】が教える「毎日食べてもやせられる」しみチョコレシピ（ヨガジャーナルオンライン）	<技術開発>,<研究>,<生活>	<技術>
他社にない特徴を出すという“間違った差別化”が成功を遠ざける　成功事例に見る、「PMF」達成の2つのステップ	<見解>,<コラム>	<オピニオン>
まちづくりの成功事例、成功の秘訣　國學院大學観光まちづくり学部・学部長　西村幸夫教授に聞く		
APEX株式会社、日本テレビ「あらゆるモノを計測バラエティ！アレコレはかり隊」に出演で番組内にてLidarドローンを使用した複雑な構造物の三次元化に成功	<技術開発>,<資金>	<技術>
スペースX、スターリンク衛星と英国の通信衛星の打ち上げに成功（sorae 宇宙へのポータルサイト）	<技術開発>	<技術>
BMWで最も成功した高級車「X7」が進化「大胆なマスクやスポーティな走り」は新型を成功へと導くか？（VAGUE）	<レビュー>,<技術動向>	<技術>,<レビュー>,<オピニオン>
スペースX、スターリンク衛星の打ち上げに成功　総数は3930機に（sorae 宇宙へのポータルサイト）	<技術開発>	<技術>
シャープと東大、量子ドット技術で前進　発光とRGB画素のパターニングに成功 | 電波新聞デジタル	<業界情報>,<市場データ>,<技術開発>	<技術>
東北大など、振動発電を活用した風邪コロナウイルスセンサの開発に成功 (1)	<技術開発>	<技術>
サムスンとKDDIがネットワークスライシング技術検証成功　5G SAの商用環境で | 電波新聞デジタル		
ドコモとスカパーJSATが成層圏下層から38GHz帯の電波伝搬実験に世界で初めて成功	<技術開発>	<技術>
大林組が月面農業の土壌技術実用化へ、模擬砂で作物の栽培に成功した！｜ニュースイッチ by 日刊工業新聞社	<技術開発>,<目標>	<技術>
世界⼀包括的な代謝物測定法の開発に成功 | 研究成果 | 九州大学（KYUSHU UNIVERSITY）	<技術開発>,<研究>	<技術>
100パーセント植物由来のペットボトル開発に成功 (2021年12月11日)	<技術開発>	<技術>
ゼロカーボン窒素肥料の作出に成功 | 理化学研究所	<技術開発>	<技術>
慶大ら，マイクロ光コムの精密制御に成功	<技術開発>	<技術>
「韓国初の民間ロケット『ハンビッＴＬＶ』、試験打ち上げ成功」（中央日報日本語版）		
ロケットラボ、BlackSkyの地球観測衛星2機の打ち上げに成功（sorae 宇宙へのポータルサイト）	<技術開発>	<技術>
ファミコン移植が大成功! 粒ぞろいだったコナミの“名作シューティングゲーム”3選（ふたまん＋）	<紹介>,<レポート>	<レビュー>
会社員で不動産投資に「成功した」人の割合は?	<市場データ>,<社会統計>,<レビュー>	<社会>,<レビュー>
女性40代からの転職　「やりがい」重視が成功のカギ	<レビュー>	<レビュー>
「アップガレージ登壇！小売業界のGoogleマップ活用成功事例～売上アップを実現したクチコミ施策とは～」ウェビナーを3/2に開催決定！	<セミナー>,<市場動向>,<施策>,<コラム>	<イベント>,<オピニオン>
田中みな実と宇垣美里の明暗…キャラ丸かぶり元女子アナ「女優」で成功するのはどっち？ - トピックス｜Infoseekニュース	<資金>,<レビュー>	<レビュー>
核融合研、中性子を生成しない軽水素ホウ素反応実験に成功 |  財経新聞	<技術開発>	<技術>
再発神経芽腫に対する同種幹細胞移植後の抗GD2抗体Dinutuximab β＋低用量インターロイキン2併用療法、治療成功率54.4％を示す	<方針>	
岩手大、音波振動で動物の妊娠環境を瞬時に作り出す技術の開発に成功 ―ラットに続くマウスでの成果、妊娠メカニズムの解明・ゲノム編集動物作出・絶滅危惧種の人工繁殖への応用に期待―	<技術開発>,<研究>	<技術>
ChatGPT大成功の裏にある深い闇。時給2ドル以下のケニア人にさせていた事	<コラム>	<オピニオン>
自信をもてる、大規模修繕へ。『修繕成功セミナー』無料公開中！｜マンション資産価値向上を考えている管理組合・建物オーナー・居住者向け	<目標>,<イベント>,<見解>	<イベント>,<オピニオン>
脱プラスチックを実現したマネキン！無形文化財「西ノ内和紙」を素材として採用　従来比約80％減の軽量化に成功した和紙マネキン「Waltz」がワークマン 2023年春夏製品...	<技術開発>,<利用・採用>	<技術>
ガートナー、日本企業がデータとアナリティクスで成功するために欠かせない役割を発表 - 日本経済新聞	<レビュー>,<市場動向>	<レビュー>
【書評】白川 克　榊巻亮『業務改革の教科書―成功率9割のプロが教える全ノウハウ』（日本経済新聞出版社）：教育ICT研究室：オルタナティブ・ブログ	<研究>	<技術>
【バイオデザイン学会】治療機器で成功事例創出を ベンチャーめぐり議論 : 医療・医薬情報 業界インデックス	<イベント>,<技術開発>,<政府・会談>	<イベント>,<技術>,<政策>
グローバルでサイト統合したカシオ計算機　リニューアル後の購入数は1.9倍！ 成功のカギを聞いた（Web担当者Forum）	<技術開発>,<市場データ>	<技術>
無料ウェビナー「ベトナムIT業界におけるM&A：案件を成功させるコツと有望M&A案件の紹介」開催のご案内	<セミナー>	<イベント>
一般社団法人日本惣菜協会および協力企業によるチームの一員として、『惣菜製造ロボット』の実用化に成功	<技術開発>	<技術>
ソフトバンクがGPUを使ったvRAN実機検証に成功、エヌビディアと共同で｜BUSINESS NETWORK	<技術開発>	<技術>
大成功のスーパーシルエットレースから、時代はグループCへ。2L直列4気筒ターボで臨んだ初期の日産（Nosweb.jp）	<目標>	
BtoB企業のブランディング施策「ターゲットに届かず」3割　-成功するための3つのカギとは-	<社会統計>,<レビュー>	<社会>,<レビュー>
共同発表：異常ホール効果の超高速変化を１０兆分の１秒の時間で観測することに成功～ミクロなメカニズムを解明する新手法を開拓～	<技術開発>,<研究>	<技術>
【飲食店オーナー様向け】店頭販売メニューに冷凍餃子を追加して、毎月100食完売！！営業スタイルを変更なく、売上アップに成功。対面だからこそ聞こえるお客様の声	<業績>,<サービス開始>,<商品化>,<意見>	<製品サービス>,<オピニオン>
先進的レグテック企業であるKYCコンサルティングは、リスク情報を体系化し自動でデータベース化するAIエンジンの開発に成功。情報処理学会全国大会にて受賞。	<レビュー>,<技術開発>,<表彰>	<技術>,<レビュー>
中国独自のテラヘルツ測定器、南極での運営に成功―中国メディア	<技術開発>	<技術>
地域ビジネスのオンライン集客を成功に導く、Googleマイビジネス対策の専門コンサルティング	<コラム>	<オピニオン>
スカイツリー-地上可搬局での盗聴解読の脅威のない暗号鍵共有に向けた光伝送実証に成功｜2023年｜NICT-情報通信研究機構	<技術開発>,<研究>	<技術>
加賀市で生まれたデジタルイノベーション　石川樹脂工業の挑戦と成功、背景にあるリスキリングへの取り組みとは？	<紹介>,<レビュー>	<レビュー>
昔に比べて基準は下がった！　クルマは何台売れたら「成功」と言えるのか？	<レビュー>	<レビュー>
アクセルスペースら、小型地球観測衛星用の低消費電力Ka帯無線機の開発に成功（アスキー）	<技術開発>	<技術>
東大、異常ホール効果の超高速変化を10兆分の1秒の時間で観測することに成功 - 日本経済新聞	<技術開発>,<研究>,<市場動向>	<技術>
【インタビュー】6万枚以上の紙伝票から解放！サンスターグループの年間1,500時間以上の工数削減に成功した方法とは	<対談>,<レビュー>	<レビュー>
名古屋大学　アモルファスシリカのナノ薄膜の合成に成功 – 日刊ケミカルニュース	<技術開発>	<技術>
一般社団法人日本惣菜協会および協力企業によるチームの一員として、『惣菜製造ロボット』の実用化に成功	<技術開発>	<技術>
｢成功した女性リーダー｣の相次ぐ引退…彼女たちが直面した問題とは何だったのか	<業界情報>,<レビュー>	<レビュー>
「モンベル」はなぜ過疎地でも成功するのか？ アウトドアブームとは距離を置く出店戦略：紀伊民報AGARA	<レビュー>,<技術開発>,<戦略>	<技術>,<レビュー>
「盗塁」は、じつは「とんでもなくリスキー」な戦術だった…！ リスクを上回るために必要な「成功率」		
自社技術を活用した新規事業成功の4ステップとは？成功事例を交えご紹介！ | ストックマーク株式会社	<技術開発>,<紹介>	<技術>,<レビュー>
超電導使った無線送電に成功　山形大工学部共同グループ	<技術開発>	<技術>
930km離れた水中ロボットの遠隔制御に成功	<技術開発>	<技術>
ヒット業態の仕掛け人・スパイスワークス下遠野氏が語る「成功の方程式」	<コラム>	<オピニオン>
超高速量子計算のための世界最速43 GHzリアルタイム量子信号測定に成功	<技術開発>	<技術>
～5G時代の超高速光通信テクノロジと光量子テクノロジの融合によるスーパー量子コンピュータ実現へ～	<目標>	
月探査機「嫦娥5号」の月面サンプルから水を発見。中国研究チームが月面の水の存在を示す直接的な証拠を得ることに成功	<技術開発>,<研究>,<人事>	<技術>
“とにかく素直”が成功の鍵。起業&独立スクールの講師に聞く「人生を力強く切り拓いていける人の共通点」	<レビュー>	<レビュー>
下着についた尿の「におい」はアンモニア臭ではない！？  尿のにおいの調合に成功！	<レビュー>,<技術開発>	<技術>,<レビュー>
【50代で－9kg減量に成功した栄養士が解説】健康的で太らない「たんぱく質」の摂り方（ヨガジャーナルオンライン）	<コラム>	<オピニオン>
国立研究開発法人 森林研究・整備機構 森林総合研究所／スギ全染色体の塩基配列解読に成功 —無花粉品種の効率開発や気候変動影響の高精度予測可能に—	<研究>,<技術開発>,<レビュー>	<技術>,<レビュー>
高級ギターメーカーが過去最高の売上を叩き出した秘訣【サブスクサービスの成功例】		
企業の挑戦・成功理由を紐解くWeb番組『Business Success Factors』を開設！第一弾は「Tokyo Prime」での放映も実施	<設備投資>,<サービス開始>,<営業活動>	<製品サービス>
サイボウズ青野氏が聞く、DXが成功する企業の共通点　中小企業の経営者こそ「リスキリング」をするべき理由	<レビュー>	<レビュー>
中国との提携で「大成功を収めている」 合弁家電企業ブラジル側創業者	<コラム>	<オピニオン>
「RSL、店舗のニーズに対応」【楽天の松村亮常務執行役員に聞く㊦】　OMOは成功事例	<技術開発>,<説明>	<技術>,<レビュー>
三菱重工が世界初、液体窒素を冷熱エネ源に発電実証成功（ニュースイッチ）		
アンリツと京セラ、「PCIe5.0」で光信号伝送試験に成功	<技術開発>	<技術>
永久凍土に眠るウイルス蘇生に成功　新たなパンデミックへの危惧も |  財経新聞	<技術開発>	<技術>
日本が先導の小惑星探査は「計画以上の成功」、アメリカは秋に「ベンヌ」から試料持ち帰りへ	<目標>	
世界初の標準外径19コア光ファイバーで1.7Pbps、63.5kmの伝送実験に成功。NICTと住友電工　伝送容量・距離の2つで記録を更新	<技術開発>,<サービス更新>	<技術>,<製品サービス>
月の撮影も可能――天体望遠鏡サイズの平面メタレンズ作製に成功 - fabcross for エンジニア	<レビュー>,<技術開発>	<技術>,<レビュー>
環境移送ベンチャーイノカ、アクアリウム発のイノベーション創出をめざす「第1回 INNOVATE AQUARIUM AWARD」を開催、小学生や希少種の育成に成功している初代受賞者6名が決定	<イベント>,<表彰>	<イベント>
下着についた尿の「におい」はアンモニア臭ではない！？  尿のにおいの調合に成功！	<レビュー>,<技術開発>	<技術>,<レビュー>
東北大など、振動発電を活用した風邪コロナウイルスセンサの開発に成功 (2)	<技術開発>	<技術>
不安定な設置状態下でも高成功率でアンカーボルトを打ち込む技術を紹介 - 日立	<技術開発>	<技術>
【EC事業担当向け】iDAが「ECサイト売上UP成功事例50選～ツール別事例紹介～」を無料配布	<イベント>	<イベント>
日本無線、山岳地域で物資輸送するドローン開発に向けた通信実証に成功	<技術開発>	<技術>
エロワードを聞くと吐き気がする…下ネタが苦手な21歳女性が男性向け｢オナホ｣の起業で大成功したワケ クリエイティブで競われる欲求の深い市場にコンセプト力で参入	<レビュー>,<サービス開始>,<業界情報>,<方針>	<製品サービス>,<レビュー>
女性は仕事も家庭も「すべてを手に入れる」ことが成功なのか？ | すべてを手に入れたから「勝ち組」という発想はもう古い！	<レビュー>	<レビュー>
岐阜大、タンニンのタンパク質凝集モデルの作成に成功―ポリフェノールの渋みや生物活性メカニズムの解明に期待―	<技術開発>,<研究>	<技術>
【スターウォーズの世界が現実に!? 】米がついにAI戦闘機の飛行訓練に成功！「X-62A」がもたらす“新時代の航空戦”とは（集英社オンライン）	<レビュー>,<技術開発>	<技術>,<レビュー>
【営業DX無料セミナー2選】商談化率2倍！成功するインサイドセールス組織のための育成・KPI設計	<紹介>,<レポート>	<レビュー>
3次元イメージング！中国の宇宙ステーションによる2光子顕微鏡テストに成功	<技術開発>	<技術>
東海大学 学生ロケットプロジェクト｜北海道大樹町で打上げ実験に成功	<技術開発>	<技術>
「１年に２００万ドル注ぎ込んで５年若くなった」若返りに成功したという４５歳富豪の真実（中央日報日本語版）	<資金>,<レビュー>	<レビュー>
実験モジュール「夢天」、燃焼実験キャビネットが初の点火実験に成功 | Science Portal China	<技術開発>	<技術>
【Ｈ３発射失敗】原因究明し次こそ成功を | 高知新聞	<レビュー>,<障害>	<社会>,<レビュー>
従業員の運動習慣化率の向上、BMI改善を通して企業の健康経営を成功に導く「Beatfit for Biz」、「健康経営銘柄2023」にて導入企業11社が大規模法人部門上位資格「ホワ...		
あえて成功を目指さない…｢Fラン大学｣出身で人事評価トップ5%になった人が共通してやっていた"3つのこと" ｢学閥あり｣の同期を逆転し､差をつける行動習慣	<方針>,<目標>,<コラム>	<オピニオン>
クラウド戦略の成功を示すのはセキュリティ--HashiCorpセキュリティ担当幹部に聞く	<戦略>	
【米国VC流長期的な組織の作り方】ズームやツイッターへの早期投資に成功したSozoベンチャーズの人材採用	<技術開発>,<利用・採用>	<技術>
JDLAが「G検定」によるリスキリング成功事例を集めた「リスキリング特集」を公開	<イベント>,<レビュー>	<イベント>,<レビュー>
京都・女子大生タリウム殺人　「舞妓ビジネス」で成功の容疑者、父は“謎の死”を遂げていた（デイリー新潮）	<社会事件>,<コラム>	<社会>,<オピニオン>
建ロボテック、鉄筋結束トモロボ型式Ｘ３の開発に成功！	<技術開発>	<技術>
定年後のセカンドキャリア　見つけ方や成功のコツを実例とあわせて紹介（Reライフ.net）	<レビュー>	<レビュー>
京大など、高温超電導モーターの室温運転に成功　焼損防ぐ新技術開発	<技術開発>	<技術>
産総研、力を加えることで蓄えた熱を取り出せる金属系蓄熱材料の開発に成功 (1)	<技術開発>	<技術>
中国、リモートセンシング衛星「ホルス2号」の打ち上げに成功	<技術開発>	<技術>
中国、地球観測衛星を相次いで打ち上げ成功（sorae 宇宙へのポータルサイト）	<技術開発>,<方針>	<技術>
和歌山県産高級バナナ「密の月」を使用したクラフトビール開発に成功し新たなるブランド化へ	<技術開発>,<目標>	<技術>
AI画像解析ウェビナー│成功するDX推進のキーポイントとは？小売・流通・物流業界別の事例をご紹介（3月15日開催）	<レビュー>,<紹介>	<レビュー>
I-ne×売れるネット広告社×ネットショップ支援室登壇！D2C（ネット通販）事業における「ブランドの成功ノウハウとEC戦略」を大公開！『D2Cの会』売上アップ＆EC戦略公開セミナー	<セミナー>	<イベント>
ロシア、「ソユーズMS-23」宇宙船の打ち上げに成功 - 故障した宇宙船を代替	<技術開発>	<技術>
【大成功】「週4日勤務」を実験したら、サイコーすぎた	<実験>,<コラム>	<技術>,<オピニオン>
陸に海を再現!!「陸生まれ・陸育ち」【完全陸上養殖さば】の養殖に成功しました！	<技術開発>	<技術>
実験モジュール「夢天」、燃焼実験キャビネットが初の点火実験に成功―中国	<技術開発>	<技術>
露の軟禁女子大生　脱出に成功		
浜ホト，100Jのパルスレーザーの10Hz発振に成功	<技術開発>	<技術>
タンデム触媒による新しいC-H官能基化反応の開発に成功	<技術開発>	<技術>
株式会社オルツ「分散秘匿計算」に成功。データを暗号化したままネットワーク越しのGPUで協調深層学習。	<技術開発>	<技術>
京大、シール化して積層することで「3次元ナノアンテナ」の開発に成功	<技術開発>,<資金>	<技術>
時速240kmで空飛ぶバイク「Speeder」のプロトタイプ飛行試験が成功		
ファブレス企業とは？OEMと何が違う？アップル、キーエンスなど成功事例も解説（ビジネス＋IT）	<レビュー>	<レビュー>
低損失基板を採用した「ローカル5G ミリ波用アンテナ」 開発に成功	<利用・採用>,<技術開発>	<技術>
テラヘルツ帯マルチビームアンテナの開発に成功 | e.x.press	<技術開発>	<技術>
膨潤に伴う高分子鎖の切断を可視化することに成功 高分子材料のミクロな劣化・破壊挙動の理解に貢献	<技術開発>,<説明>	<技術>,<レビュー>
高靱性・高耐ヒートショックのボンド磁石材料戸田工業が開発に成功 | 電波新聞デジタル	<技術開発>	<技術>
いまこそDXへの意識を変革せよ。Amazon×千代田化工建設、経営視点で押さえるべきDX成功ポイント	<レビュー>,<行動変化>	<レビュー>
永久磁石の3次元透視に成功、保磁力メカニズム解明へ　大同特殊鋼、東北大学など　 | 電波新聞デジタル	<技術開発>,<資金>,<目標>	<技術>
ティエムファクトリ、自社製エアロゲル「SUFA」にて驚異の透過率91%のモノリス体の作製に成功	<技術開発>	<技術>
骨再生医療の足場に活用、大阪市大が多孔体に親水性を持たせることに成功	<利用・採用>,<技術開発>	<技術>
ＢＡＳＦら部品製造に成功　マスバランス方式のプラから	<技術開発>	<技術>
イーロン・マスクの次の標的、脳にチップを埋める“ニューラリンク”は成功するか？「自分が最初の実験台になる」と宣言＝浜田和幸	<レビュー>,<方針>	<レビュー>
世界初、クチナシ青色素の分子構造解明に成功	<技術開発>	<技術>
自閉症の可能性を31倍高める母親の自己抗体を特定することに研究者が成功	<技術開発>,<方針>	<技術>
「皮膚ガス」を高感度検知し「見える化」に成功、種々の医療応用に期待－東京医歯大	<技術開発>,<見解>,<要望>	<技術>,<政策>,<オピニオン>
成熟膵島細胞を増やすことに成功 ～糖尿病の根治に向け、新たな再生治療法の可能性を発表～｜東京大学医科学研究所	<技術開発>,<目標>,<レビュー>	<技術>,<レビュー>
人工筋肉の寿命を最大100倍にすることに成功　NEDOと中央大学	<市場データ>,<技術開発>	<技術>
サプライチェーンとは？サプライチェーンマネジメント（SCM）の手法と成功事例をご紹介	<レビュー>,<紹介>	<レビュー>
JFCCら，パワー半導体の結晶欠陥イメージングに成功	<技術開発>	<技術>
ラムダ型五酸化三チタン、高品質単結晶薄膜の形成成功　東北大		
光造形3Dプリンタ装置による複雑な形状の金属・樹脂の精密3次元構造体の作製に成功	<技術開発>,<資金>	<技術>
水素-酸素バーナーを用いた燃焼技術によるガラス溶融に成功	<技術開発>	<技術>
グローバルECを成功に導くAdobe Commerce（Magento）導入支援サービス	<サービス開始>	<製品サービス>
数値近似解法のひとつの理論的裏付けに世界で初めて成功 | 研究成果 | 九州大学（KYUSHU UNIVERSITY）	<技術開発>,<研究>	<技術>
【フランス】Carbios、廃PETのケミカルリサイクルでミシュランのタイヤ生産に成功。サーキュラー化	<技術開発>	<技術>
肺癌の細胞診検体を用いたコンパクトパネル検査は成功率100％でコンパニオン診断としての性能も良好【WCLC 2		
NEXT医療機器開発シンポジウム～日本からの医療機器開発を成功に導くためには～	<イベント>	<イベント>
社内ポータル活用でDXを推進、大企業での導入を成功させる4つのポイントとは？	<レビュー>	<レビュー>
【筋トレ ビフォーアフター】ネガティブ保育士が体脂肪率20％減に成功しビキニで海へ！（FITNESS LOVE）	<技術開発>	<技術>
オール酸化物全固体Naイオン二次電池世界初 日本電気硝子が駆動に成功 | 電波新聞デジタル	<技術開発>	<技術>
キリン淡麗とサントリー金麦　リブランド戦略、成功へ緻密な計算		
銀ナノインク「Picosil(R)」を用いた低温プロセスでの超細線描画に成功	<技術開発>	<技術>
企業や自治体の災害担当者必見！スマートレジリエンスの成功事例	<説明>	<レビュー>
ヤマハ発動機株式会社様 — 成功事例	<説明>	<レビュー>
トタルエナジーズ社と自律型無人潜水機（AUV）を用いた共同研究海上試験に成功 | プレスリリース | 川崎重工業株式会社	<技術開発>,<商品化>	<技術>,<製品サービス>
次世代高効率ディスプレイ向けCdフリー量子ドットで、RGB画素のパターニングに成功	<技術開発>	<技術>
DevOpsで成功するには"ハイブリッド"な人材が重要に	<技術開発>,<レビュー>	<技術>,<レビュー>
生分解性ポリエステルと腸内細菌の働きで炎症性腸疾患の病態抑制に成功　麻布大学など	<技術開発>	<技術>
分子ロボットの「群れ」の実働に世界で初めて成功 | e.x.press	<技術開発>	<技術>
新規事業開発に挑み続けるための“撤退基準”の定め方──成功に向けた「健全な多産多死」を実現するには	<技術開発>	<技術>
"柔固体"型電池の共同開発に成功～新素材による高容量化で、次世代電池の早期実用化に貢献～ | ニュースリリース | 住友化学株式会社	<技術開発>,<説明>,<商品化>	<技術>,<製品サービス>,<レビュー>
国立大学法人千葉大学 目に見えない静電気を分子レベルで観測することに成功～材料固有の帯電特性の解明へ前進～	<技術開発>,<研究>,<業界情報>	<技術>
資生堂、スパチュラ自立格納容器の開発に成功｜週刊粧業オンライン	<技術開発>	<技術>
CO2削減に貢献する新素材コンクリートの製品の試験製造に成功	<技術開発>	<技術>
    ～アルカリ活性材料を用いた意匠性を有する低炭素型プレキャストコンクリート製品～		
東北大、音波の振動方向の回転を磁石の元となる電子の自転（スピン）に移すことにより磁石の向きを制御することに成功	<技術開発>	<技術>
クラウド推進の取り組みを一元化するCCoE、成功に必要な要素は（前） - クラウド推進の取り組みを一元化するCCoE、成功に必要な要素...：Computerworld		
千葉大、絶縁材料表面の静電気を非接触で高感度に検出・可視化に成功 (1)	<技術開発>	<技術>
産総研：新規質量分析法とバイオインフォマティクスの統合によるメタボローム解析の新たなハイスループット・プラットフォーム“PiTMaP”の開発に成功！！	<技術開発>	<技術>
産総研：ペロブスカイト太陽電池の耐久性向上に貢献する新規有機ホール輸送材料の開発に成功	<技術開発>,<説明>	<技術>,<レビュー>
アジサイの青色色素の可視化に成功	<技術開発>	<技術>
自動車用の蓄熱セラミックスの開発に成功 - 東京大学 大学院理学系研究科・理学部	<技術開発>,<研究>	<技術>
米国海軍研究所がレーザー送電実験を実施、325mの距離で400Wの伝送に成功 |  財経新聞	<実験>,<技術開発>	<技術>
【4/4限定配信】Forrester Research、Tuthill、Rudolf Leiner社をお招きし、Webセミナー「商品コンテンツでeコマースの成功を確かなものに」を開催決定！：時事ドットコム	<営業活動>,<イベント>	<イベント>,<製品サービス>
世界初の洋上用CO2回収装置検証プロジェクトで排ガスからのCO2分離・回収に成功	<技術開発>	<技術>
“硝酸イオン”を効率的に吸着できる炭素繊維の開発に成功	<技術開発>	<技術>
電場による磁石極性の反転に成功―次世代低消費電力磁気メモリー実現の道拓く―	<技術開発>	<技術>
SNS担当の悩みを解消し、負担を軽減 成功のノウハウを蓄積できるSNS分析・運用ツール	<技術開発>	<技術>
和牛肉の匂い「画像」に　輸入と異なるパターンに　静岡県立大大学院が成功 / 日本農業新聞公式ウェブサイト	<目標>,<効果>	
物理発泡技術の効率化・コスト削減に成功、新素材メーカー「大毛牛」が独占市場打破へ（36Kr Japan）	<技術開発>,<市場動向>,<目標>	<技術>
成功はデータにあり、データは成功にある！ Salesforceによる最新マーケティングインテリジェンスレポート	<コラム>,<情報公開>,<レポート>	<オピニオン>
微弱な光を検出できる「有機光ダイオード」試作、東洋紡が仏政府系研究機関と成功｜ニュースイッチ by 日刊工業新聞社	<実験>	<技術>
テレワーク率80％以上の経理部門を実現、マネーフォワード クラウド導入に成功した企業の生の声を聞く	<技術開発>	<技術>
CVC(コーポレート・ベンチャーキャピタル) の成功事例について解説！	<説明>	<レビュー>
「飲食・食品事業経営者向けセミナー」開催。飲食店M＆Aを成功させるポイントとは？ 飲食M&A by 飲食店.COM	<セミナー>,<レビュー>	<イベント>,<レビュー>
ダイセル、銀ナノインク「Picosil」による超細線描画に成功 	<技術開発>	<技術>
ジェイテクト、レアアースの使用を抑えた重希土類フリーモータの開発に成功	<技術開発>	<技術>
時代に最適なコミュニケーションへの進化、「Notion」活用で業務効率が向上した成功事例 4選	<レビュー>,<技術開発>,<紹介>,<レポート>	<技術>,<レビュー>
［DX推進の成功率16％］富士通、旭化成、ソニー、ヤフーの先進DX事例とは【オンラインラーニングフォーラム2022】	<コラム>	<オピニオン>
成功するIPランドスケープと失敗するIPランドスケープ	<レビュー>,<障害>	<社会>,<レビュー>
オルツ、日本発大規模言語処理モデル「LHTM-2」の開発および個性化に成功GPT-3と同水準のパラメータ数で従来の大規模言語モデルの課題を改善し、AIクローンの社会実装を本格化 | alt	<技術開発>	<技術>
オルツ、日本発大規模言語処理モデル「LHTM-2」の開発および個性化に成功	<技術開発>	<技術>
アデノ随伴ウイルス、凍結乾燥後の生物活性維持　東大・モリモト医薬が成功		
“人類無比の頭脳”ジャック・アタリが指摘する日本の成功と失敗　もう一度世界の将来を担うのに必要な3つの条件とは〈dot.〉（AERA dot.）	<意見>,<レビュー>,<障害>	<社会>,<レビュー>,<オピニオン>
双極性障害の躁・うつの両方の症状を示す世界初の動物モデルの作製に成功｜順天堂	<技術開発>	<技術>
蘭産学チーム、熱可塑複合材胴体下面の製造成功 – 旅行業界・航空業界 最新情報 − 航空新聞社	<生産活動>	<製品サービス>
時間に限りがあることを無視。巷の「成功術」が放つ“うさん臭さ”の正体	<レビュー>	<レビュー>
地方移住者の4割が「成功とも失敗とも言えない」…後悔したことの上位は“人間関係”ではなかった（FNNプライムオンライン）	<障害>	<社会>
ハイブリッドエンジンパワーユニットを搭載したドローンのテスト飛行に成功	<技術開発>	<技術>
「日の丸コンテナ会社 ONEはなぜ成功したのか」著者に聞く、「出島組織」が原動力。理由は市況だけではない|日本海事新聞 電子版	<レビュー>,<市場動向>	<レビュー>
同業者による取り組みを参考に／作業工程分析がＤＸ化、成功の近道／リクルート 風間駿輔氏に聞く	<目標>,<技術開発>,<研究>	<技術>
NFT×リアル〜NFTビジネス成功の鍵とは〜 (2023/02/28 19:00〜)	<レビュー>	<レビュー>
低軌道衛星コンステレーションに向けた耐放射線Ka帯フェーズドアレイ無線機の開発に成功 高速通信可能な衛星搭載用無線機の低コスト化に貢献	<技術開発>,<説明>	<技術>,<レビュー>
会社の事業を引き継ぐ成功例を紹介　“ドムドムバーガー”のトップの基調講演も　札幌市で「事業承継」のシンポ開催（HBCニュース北海道）	<紹介>	<レビュー>
経営ひと言／ダスキン・大久保裕行社長「成功の足がかり」		
NASA、全電気航空機のモーターコントローラ熱試験成功 – 旅行業界・航空業界 最新情報 − 航空新聞社	<実験>	<技術>
釜山万博誘致成功なら「空飛ぶクルマ」披露　誘致委が企業と協力（聯合ニュース）	<情報公開>,<提携>	<提携>
資金調達できるプレゼン資料の作り方。成功したスタートアップに学ぶ10のテクニック (Business Insider Japan)	<コラム>	<オピニオン>
ワニの遺伝子をナマズに移植することに成功。ハイブリッドな「ワニナマズ」で感染症予防対策	<技術開発>,<対策>,<社会問題>	<技術>,<社会>
「自尊心」は高い方が成功しやすいのか　心理学の研究で分かった「困った時の対処法の違い」とは（デイリー新潮）	<レビュー>	<レビュー>
防寒とお洒落の“二兎追い”コーデ。冬の種カジ、成功の秘訣は素材にあり！（OCEANS）	<コラム>	<オピニオン>
​アリフィッシュとサンリオ、初のキャンペーンを成功裏に終了	<サービス終了>	<製品サービス>
新着情報: 顎関節の退行性病変に関わる新規分子の同定に成功～顎関節の退行性病変のバイオマーカーとして新たな臨床検査や治療法の開発に期待～（歯学研究院　教授　飯村忠浩）	<技術開発>	<技術>
3/14(火)CloudSign Re:Change Japan 2023 Springにて「不動産業界における電子契約導入の3つハードルと成功事例」をテーマにいえらぶGROUP常務取締役 庭山が登壇	<セミナー>	<イベント>
「CNET Japan Live 2023」にハウスコム 代表が登壇　組織戦略とカスタマーサクセス(顧客の成功)をテーマに今後の戦略を紹介	<紹介>,<戦略>	<レビュー>
特殊改造した「完全自律型F-16戦闘機」人間の介入なしに離着陸を含めた17時間のフライトに成功！	<技術開発>	<技術>
オンライン認知機能検査「脳検」受検時間の短縮化に成功、国際的な医学誌（Dementia and Geriatric Cognitive Disorders）に掲載	<技術開発>,<政府・宣言>,<情報提供>	<技術>,<政策>
ミスターちん（59）が語った鍼灸師としての現在「リスキリング」成功の舞台裏（NEWSポストセブン）	<レビュー>	<レビュー>
アデノ随伴ウイルス、凍結乾燥後の生物活性維持　東大・モリモト医薬が成功		
バイオ由来　高バイオマス度の高吸水性ポリマーの開発に成功	<技術開発>	<技術>
500km離れた東京-神戸間で5G SAを活用しロボット手術を支援する実証に成功	<技術開発>	<技術>
バイオ由来　高バイオマス度の高吸水性ポリマーの開発に成功	<技術開発>	<技術>
日本が全固体電池の開発に成功、中国自動車企業は危機感を―中国メディア - 記事詳細｜Infoseekニュース	<技術開発>	<技術>
慶應義塾大、慢性期脊髄損傷に対する細胞移植の治療効果を高めることに成功－リハビリテーションとの併用治療で運動機能回復－	<技術開発>,<方針>,<業界情報>	<技術>
北大、実用化可能な全固体電気化学熱トランジスタの作製に成功 (1)	<技術開発>	<技術>
ハートシード、他家ｉＰＳ由来 １例目投与に成功 - 化学工業日報 電子版	<技術開発>	<技術>
絶滅危惧種クマタカ、撮影に成功　尾花沢・玉野小	<技術開発>	<技術>
【2月15日(水) 11:00】無料ウェビナー『集客・SNS運用・組織形成のプロが成功事例を元に解説するECの売上アップノウハウ』を開催	<セミナー>	<イベント>
脳傷害後の神経再生を促す超分子バイオマテリアルの開発に成功 | 報道発表の新着情報 | 名古屋市立大学	<技術開発>	<技術>
ユキヒョウ4頭が一緒に映る貴重な映像の撮影に成功―中国	<技術開発>	<技術>
生理学研究所・名古屋市立大・同志社大など、脳傷害後の神経再生を促す超分子バイオマテリアルの開発に成功	<技術開発>	<技術>
水滴を「融合させず」水面上で90分間もバウンドさせることに成功！	<技術開発>	<技術>
成功に導くために！“偏ったダイエット”を防ぐ秘策とは？ |	<技術開発>,<レビュー>	<技術>,<レビュー>
企業の価格転嫁　成功理由首位は「原価提示」　農林水産業は値上げ進まず / 日本農業新聞公式ウェブサイト	<業界情報>	
【展望】マスクがツイッターで、「スペースX社の試験、成功！」	<レビュー>,<実験>,<技術開発>	<技術>,<レビュー>
北大と阪大、ＥＵＶ光源プラズマの流れ計測成功		
【神戸アリーナ】「絶対に成功させる」、民設アリーナ3社トップが対談（サンテレビ）	<対談>	
TIS、DX ・ITプロジェクトを成功に導く「RoboPMO」のクラウド版を提供開始	<サービス開始>,<技術提供>	<製品サービス>,<提携>
中国スパイ気球の「残骸から電子機器」、センサーなど搭載物の大半の回収成功か	<レビュー>	<レビュー>
インターステラテクノロジズ、ZERO用フェアリングの分離放てき試験に成功（sorae 宇宙へのポータルサイト）	<技術開発>	<技術>
3Dプリンターで高さ10メートルの仏像再現に成功 中国	<技術開発>	<技術>
デイブ・スミス：成功の香り	<レビュー>	<レビュー>
新規事業とは？　成功した新規事業事例9選！成功する新規事業に共通するポイントを解説 | THE OWNER	<経済>,<紹介>,<レポート>,<説明>	<レビュー>
低品位フライアッシュ/ジオポリマー用に処理/実機ミキサーで製造成功/西松建設と北九州市立大がメド		
小売業が広告配信のプラットフォーマーに　オンラインとリアル店舗のデータを融合した「リテールメディア」成功の鍵は？	<目標>,<技術開発>,<レビュー>	<技術>,<レビュー>
なぜ世の中には「むごい1on1」が生まれてしまうのか？：リモート1on1を含め、1on1の失敗と成功のポイントを映像教材化！	<コラム>	<オピニオン>
導電性高分子を用いた「物理リザバー計算」による音声認識、九工大が成功		
眺める方向によって明るさが変わる磁石の開発に成功 有機・無機ハイブリッドペロブスカイト系材料の新しい光機能を開拓	<技術開発>	<技術>
米国で成功したスタートアップが最初に進出したい海外市場は「二択」。中国、ブラジル、欧州…それとも日本？	<レビュー>	<レビュー>
葛飾区町工場、大学と共同研究で疑似量子アニーリングイジングマシンの最適化実装に成功｜fabcross	<技術開発>	<技術>
新着情報: 光の力でナノ粒子を一粒ずつ選別・輸送することに成功～医薬品，バイオセンサー，太陽電池，量子コンピューターの高品質化・高性能化への応用に期待～（電子科学研究所　教授　笹木敬司）	<技術開発>	<技術>
不動産投資の注目トレンド「賃貸併用住宅」。サラリーマン大家に聞く、成功の3原則		
脱炭素へ「事業撤退」の決断も　柔軟性、成功のカギに	<レビュー>,<目標>	<レビュー>
「なぜ９％のサブスクしか成功しないのか？」と題して、（株）クニエ　新規事業戦略コンサルタント　渡部　嵩大 氏によるセミナーを2022年３月１０日（木）オンラインに...		
年間700万UUを達成した「普通」な施策とは?「アマノ食堂」のWeb担当者に聞いた | はてなが訊く「オウンドメディア成功の法則」	<市場データ>,<施策>	
外壁塗装に関するメディア・ブログ運営「外壁塗装成功塾」をスタート	<サービス開始>	<製品サービス>
二子玉川ライズで都市DXプラットフォームの技術実証に成功	<技術開発>	<技術>
世界初 ワイヤレス給電 環境センサーの完全無線稼働に成功	<技術開発>	<技術>
ウミトロン、陸上養殖向けスマート給餌機を開発し、AIによる自動判断での生育管理に成功	<技術開発>	<技術>
IoT投資の世界市場調査（前編）、用途別トップ10は？成功事例と併せて解説	<レポート>,<レビュー>	<レビュー>
「経営戦略を成功に導く知財戦略【実践事例集】」が示す、オープンイノベーションにおける知財戦略とは？	<方針>,<戦略>,<レビュー>	<レビュー>
東大と産総研、機械的刺激によって食塩の結晶成長が加速する現象を高速・高分解能の電子顕微鏡で映像化することに成功	<技術開発>	<技術>
協力し合えば強くなる、半導体量子ドットの集団増強効果の観測に成功 －量子センサーやエネルギー変換に新たな道－	<技術開発>	<技術>
東大など、球形コロイド粒子の回転運動の観察に成功	<技術開発>	<技術>
AIが異音検知！超音波による機器故障の早期発見に成功？DX効果も期待できるSOMPOグループの実験とは | Techable(テッカブル)	<技術開発>,<レビュー>,<効果>,<実験>	<技術>,<レビュー>
武田薬品とCiRA、筋肉の遺伝子治療用LNPの開発に成功	<技術開発>	<技術>
減量の成功に、「デジタルツールを用いた自己管理」が有用－米スタンフォード大ほか	<技術開発>	<技術>
世界初、低濃度アンモニア水から高純度水素を製造　燃料電池の発電に成功	<生産活動>,<技術開発>	<技術>,<製品サービス>
【研究成果】光干渉効果を利用し、低コストで有機薄膜太陽電池を飛躍的に高効率化することに成功	<研究>,<技術開発>	<技術>
凸版印刷、環境発電で動作する電子ペーパーを開発―EnOcean端末で表示に成功	<技術開発>	<技術>
JAEAら，シリコン酸化膜の成長過程の観察に成功	<技術開発>	<技術>
全固体電池内のリチウムイオンの動きを捉えることに成功	<技術開発>	<技術>
時間分解走査トンネル顕微鏡の簡易化・安定化に成功～1000億分の1秒と10億分の1メートルの精度で電子の動きを測定する技術の普及に道を開く～ | TSUKUBA JOURNAL - テクノロジー・材料	<技術開発>	<技術>
てんかん発作を自動検出するAIの開発に成功、検出精度は最大100%	<技術開発>	<技術>
電通大，中間バンド太陽電池の2段階光吸収に成功	<技術開発>	<技術>
液体アンモニア噴霧の安定燃焼に成功――アンモニアガスタービン発電の実用化に近づく　東北大	<技術開発>	<技術>
広島大と京大、免疫応答の数理モデル開発　アレルギー発症再現に成功	<技術開発>	<技術>
東北大、ゴムの弾性熱量効果を活用した冷却機構の高効率化に成功 (1)	<効果>,<技術開発>	<技術>
導電性100倍以上、３Ｄプリンターで３Ｄフレキシブル配線造形に成功した意義 ニュースイッチ by 日刊工業新聞社	<技術開発>	<技術>
ソニーの超小型人工衛星『EYE』が軌道上での通信確立に成功	<技術開発>	<技術>
中国、今度は水素で覇権目指す－太陽光パネルの成功再現なるか	<海外展開>,<方針>,<目標>,<レビュー>	<レビュー>
京大ら，光合成をやめた藻類の全ゲノム解読に成功	<技術開発>	<技術>
水素化反応３０倍以上に加速、東大が成功した意義｜ニュースイッチ by 日刊工業新聞社	<方針>	
CVR45％増の事例も！ JTBのDMPを用いたデータドリブン成功の秘訣 | インタビュー	<説明>,<技術開発>,<対談>	<技術>,<レビュー>
重野和稔著『飲食業界　成功する店　失敗する店』すばる舎刊		
「あの事業撤退がなければ今の成功は無かった」bravesoft社長が語る日本一ポジティブな事業撤退の裏側	<レビュー>	<レビュー>
複業の実践書が発売決定、予約販売スタート！大複業時代の到来前に押さえておきたい、成功の秘訣と注意点を徹底解説	<商品化>,<サービス開始>,<説明>	<製品サービス>,<レビュー>
初心者必見！STP分析の活用例と成功事例を用いてわかりやすく解説	<コラム>	<オピニオン>
名大ら，可視光で概日リズムの可逆的な操作に成功	<技術開発>	<技術>
大同特殊鋼、水素を燃料とするラジアントチューブバーナを開発し水素混焼および専焼テストに成功	<技術開発>	<技術>
SKT、透明アンテナ RIS技術開発に成功…室内通信品質の強化	<技術開発>,<方針>	<技術>
「高血圧」はコロナ重症化リスク…塩分約40％カットに成功「減塩笹かまぼこ」とは【宮城発】（FNNプライムオンライン）	<レビュー>,<障害>,<技術開発>	<技術>,<社会>,<レビュー>
放射線遮蔽材の開発に成功　早川ゴムの配合技術が貢献	<技術開発>,<説明>	<技術>,<レビュー>
福島大、インクジェット印刷技術を応用して、極薄の曲げられる太陽電池の開発に成功	<技術開発>	<技術>
世界初の量子衛星の打ち上げも成功  中国、暗号法など布石着々  量子技術覇権大国の野望		
メルカリ、日清食品らの元ITトップ「武闘派CIO」たちが忖度抜きで明かすDX成功の条件	<レビュー>	<レビュー>
【ビジネスの裏側】次世代建材、日本初の成功　なんとＣＯ２排出８割減…大ガスが“畑違い”に挑むワケ	<レビュー>,<技術開発>	<技術>,<レビュー>
血液適合性ポリマーの高靱性化と3Dプリンター加工に成功――医療器具の簡便な成形手法としての応用に期待　名大とユニチカ	<技術開発>,<レビュー>	<技術>,<レビュー>
リチカ、AIナレーションによる成功４事例を公開	<説明>	<レビュー>
ダンゴムシの脚の力はどのくらい？　立命館大学が世界で初めて測定に成功	<技術開発>	<技術>
120万本売れたスティックのり　ブランド化に成功した説明資料	<情報公開>	
横浜国立大学、コーヒー粕からセルロースナノファイバーの生成に成功	<技術開発>	<技術>
目に入れるだけで立体像が見える！AR表示コンタクトレンズの開発に成功　東京農工大学	<技術開発>	<技術>
グラファイト表面にペプチド・ヘミン分子　東工大が電気化学反応に成功	<技術開発>	<技術>
バブル末期にトヨタ「セルシオ」の成功した秘訣とは？ ベンツ「Sクラス」を震えさせた静粛性にありました	<技術開発>,<レビュー>	<技術>,<レビュー>
二酸化炭素から樹脂原材料、生体触媒用いる人工光合成に成功	<技術開発>	<技術>
中国人学者、野生トウモロコシの高タンパク質遺伝子クローニングに成功	<技術開発>	<技術>
酸化ガリウムの結晶欠陥、ファインセラミックセンターなどが撮影に成功した意義 ニュースイッチ by 日刊工業新聞社	<技術開発>	<技術>
可変型の放射線遮蔽材の開発に世界で初めて成功　環境・患者様へ優しい放射線治療へ	<技術開発>,<目標>	<技術>
健康食品・サプリの開発へ！　野菜に含まれる超硫黄分子の定量検出に成功｜大阪公立大学	<技術開発>	<技術>
人間の「ミニ脳」でラットの脳損傷を修復する初の実験に成功	<技術開発>	<技術>
テックタッチがエンタープライズセールスに成功した理由とノウハウを公開します｜Soushi Nishino （テックタッチ株式会社）｜note	<レビュー>	<レビュー>
「空飛ぶクルマ」、日本初の有人飛行に成功 中国EHang社の機体を採用 | 36Kr Japan | 最大級の中国テック・スタートアップ専門メディア	<政府・宣言>,<利用・採用>	<技術>,<政策>
“関節の痛み”和らげる新たな治療法の開発期待　ｉＰＳ細胞を使い、サルの膝関節再生に成功（読売テレビ）	<技術開発>	<技術>
ロケット打ち上げ「失敗」記者に「国益に反している」苫米地氏が批判 「科学的な立場では成功」持論	<コラム>	<オピニオン>
ASO対策ツールAppTweakを活用して、アプリストアでのランクUPに成功！コインチェック株式会社の導入事例を公開	<技術開発>,<説明>	<技術>,<レビュー>
ユナイテッドアローズの担当者が語る 「アプリやLINEを活用したCRM活用の成功と失敗」（Web担当者Forum）	<レビュー>,<障害>	<社会>,<レビュー>
白トリュフ人工栽培成功／国内初、高い希少価値：紀伊民報AGARA	<レビュー>	<レビュー>
トリュフ“人工栽培”　国内初成功「実用化に近い研究成果」　10年後めどに安定生産へ（テレビ朝日系（ANN））	<技術開発>,<研究>,<生産活動>,<目標>	<技術>,<製品サービス>
日本の次期主力ロケット　Ｈ３ロケット初号機 打ち上げ成功ならず（KKB鹿児島放送）	<技術開発>	<技術>
岸田首相、Ｈ３ロケット「敬意を表し、次の成功を期待」	<政府>,<見解>,<要望>,<技術開発>	<技術>,<政策>,<オピニオン>
au新料金プランの成約数８倍を実現したアウトバウンドコールの好事例 ～成功の裏側には顧客ニーズに応えたauサービスの豊富な知識とパートナーシップ	<価格>,<説明>	<製品サービス>,<レビュー>
ソニーの衛星「EYE」、宇宙からの写真撮影に成功（UchuBiz）	<技術開発>	<技術>
冷却材漏れの「ソユーズ」　乗組員帰還船の打ち上げ成功		
ソニーがシリコンバレーで学んだ、子会社が新規事業を成功させる秘訣	<コラム>	<オピニオン>
成功する人は必ず知っている10回に1回の法則		
ドコモら、遠隔地からロボット手術を支援する実証実験に成功――東京・神戸間で商用5G SAを活用（Impress Watch）	<技術開発>,<利用・採用>	<技術>
無料ウェビナー『MA導入の失敗を取り戻す Adobe Marketo Engage導入成功のポイント』を2月21日・3月15日に開催	<セミナー>	<イベント>
空飛ぶクルマ 笠岡で屋外有人飛行　倉敷のＭＡＳＣ 大分に続き成功：山陽新聞デジタル｜さんデジ	<業界情報>	
建設業にペーパーレス化は必要？メリットや成功事例、導入方法を紹介！ | 施工管理・業務管理システムなら【アイピア】	<レビュー>	<レビュー>
空飛ぶクルマ、笠岡湾干拓地で試験飛行成功【動画】 | 中国新聞デジタル	<実験>	<技術>
Wi-SUN FAN対応無線機1000台で自律通信試験に成功	<技術開発>	<技術>
AIは“特別な投資”ではない　「知見も人材もない」企業が自社導入に成功するコツは？　データサイエンティストに聞く	<投資>,<レビュー>	<レビュー>
アークエッジ・スペース、超小型人工衛星「OPTIMAL-1」の通信確立と画像撮影などに成功	<技術開発>	<技術>
リスキリングに関するアンケートレポート：フリーランス・副業・複業人材の27%が既に「リスキリング」を実施済みと回答。人気スキル第一位は「プログラミング」、オンラインでの効率的な学習が成功の鍵：時事ドットコム	<情報公開>,<レポート>,<コラム>	<オピニオン>
“アウトドアブランド＝男性”のイメージからの脱却、ザ・ノース・フェイスが成功したその理由	<レビュー>	<レビュー>
ロジクトロン／大型ドローンで荒川両岸のピストン輸送に成功	<技術開発>	<技術>
メルカリを“勝者”に導いた10年前の意思決定、小泉文明氏が振り返る「成功のターニングポイント」（DIAMOND SIGNAL）	<レビュー>	<レビュー>
SFAツールの導入に成功　株式会社レトリバ様の導入事例を公開【株式会社Goofy】	<説明>,<技術開発>	<技術>,<レビュー>
広域強盗に関与疑いの２人、関係者語るススキノで成功と転落…大学生で接待店を経営後「盗んだ金でバー、暴力団の小間使い」（HBCニュース北海道）		
不動産投資を成功させるには？ワンルームマンション、1棟アパート、戸建て…物件種別ごとの「出口戦略」について解説（幻冬舎ゴールドオンライン）	<レビュー>	<レビュー>
宇宙飛行に革命を！　NASAが「回転デトネーション・エンジン」の試験に成功	<技術開発>	<技術>
世界最大の飛行機「ロック」が9回目の試験飛行に成功（BUSINESS INSIDER JAPAN）	<技術開発>	<技術>
英語研修成功のコツ　ゴールを明確にしてスコアアップ（NIKKEI STYLE）	<レビュー>	<レビュー>
サケ稚魚のリモート自動計測実証実験に成功―AIを用いた空間計測技術で泳ぐ魚の自動計測が可能に― - 国立大学法人 岡山大学	<技術開発>,<レビュー>	<技術>,<レビュー>
海外転職で成功するシニア　マネジメントや営業に需要		
≪ザ・ノース・フェイスが「湘南国際マラソン」で成功させたフォーマットで大会をサポート≫「せとだレモンマラソン」が環境負荷低減を意識した「マイボトルマラソン」を採用	<技術開発>,<支援>,<利用・採用>	<技術>
ダイエットを効率よく成功させるための“運動のタイミング”はいつ？ |	<レビュー>	<レビュー>
戦闘機どうしのドッグファイト「AI」で成功 米国防省 創作物の世界が現実に…！（乗りものニュース）	<技術開発>,<政府>,<レビュー>,<目標>	<技術>,<政策>,<レビュー>
3Dプリンターで高さ10メートルの仏像再現に成功 中国	<技術開発>	<技術>
帝国データバンク、「価格転嫁の成功理由に関する企業アンケート」の結果を発表	<情報公開>,<レポート>,<政府・宣言>,<コラム>	<政策>,<オピニオン>
大林組ら／ドローンによる資材運搬試験運用開始、橋梁現場で自動自律飛行に成功 – 日刊建設工業新聞	<実験>,<技術開発>	<技術>
40代以上、年収400万円以下は「ジャンク人材」？崖っぷちからの「逆転転職」を成功させる秘訣（現代ビジネス）	<レビュー>	<レビュー>
HTBがNICTなどと共同で分散エッジを用いた8K非圧縮映像処理及び配信実証実験に成功	<技術開発>	<技術>
エンジャパンがkintoneで進めた内製化　成功の理由は情シスへのリスペクトと役割分担	<方針>,<技術開発>	<技術>
共同発表：貴金属触媒を使わずバイオマスからプラスチック原料を合成～最適構造の二酸化マンガン触媒の開発に成功～	<技術開発>	<技術>
三菱重工とJAXAの「H2A」打ち上げ成功が示したこと ニュースイッチ by 日刊工業新聞社	<方針>,<コラム>	<オピニオン>
ウシオ電機、王子HDと共同でCNF透明シート上への微細パターニングに成功 | マーケット速報 | 企業情報FISCO	<技術開発>	<技術>
【4/4限定配信】Forrester Research、Tuthill、Rudolf Leiner社をお招きし、Webセミナー「商品コンテンツでeコマースの成功を確かなものに」を開催決定！	<営業活動>,<イベント>	<イベント>,<製品サービス>
酸を用いて、プロペラ型分子トリプチセンの開環に成功！ | 研究成果 | 九州大学（KYUSHU UNIVERSITY）	<技術開発>,<研究>	<技術>
DX成功企業の事例をまとめて聴ける「DX事例合同ウェビナー」を開催。	<セミナー>	<イベント>
LINEを活用した新規顧客獲得の流れとは？成功事例やCVR向上のポイントも解説	<利用・採用>,<レビュー>	<技術>,<レビュー>
【ヨーロッパ】ソルベイとCarbios、PVDCコーティング多層PETフィルムの解重合実証に成功 | Sustainable Japan | 世界のサステナビリティ・ESG投資・SDGs	<投資>,<社会問題>	<社会>
京都大学など、ゼロカーボン飼料生産に成功	<技術開発>	<技術>
流体力学における乱流を説明する、重要な法則の数学的証明に成功	<技術開発>	<技術>
業務・アプリ・人をつなぐ横連携で本当に成功する大企業の現場開発	<コラム>	<オピニオン>
情報を電源フリーでワイヤレス送信できる微小荷重センシングシステムを開発 ―曲げ振動を利用して風邪コロナウイルスの検知に成功―	<技術開発>,<利用・採用>	<技術>
顧客体験を成功に導くコンタクトセンターとは？【顧客対応業務のアウトソーシング例】 | 『EC通販で勝つBPO活用術』ダイジェスト	<レビュー>	<レビュー>
マイクロフィンガーを用いたダンゴムシの力計測に世界で初めて成功～ミクロ世界とのインタラクションのためのインタフェースとして期待～	<技術開発>,<見解>,<要望>	<技術>,<政策>,<オピニオン>
｜立命館大学		
報道発表資料 : 世界初、成層圏下層から38GHz帯の電波伝搬実験に成功-HAPSによる成層圏からの通信サービスの提供実現に向けて- | お知らせ | NTTドコモ	<情報公開>,<技術開発>,<目標>	<技術>
ノベルクリスタルテクノロジー、酸化ガリウム150㎜ウエハー成膜に成功	<技術開発>	<技術>
クライオ蛍光顕微鏡で分子イメージングに成功 鍵はナノレベルのピント合わせにあり	<技術開発>	<技術>
光合成色素からなるナノリングの構築に成功 ～新しい光機能材料への展開に期待～｜国立大学法人名古屋工業大学	<技術開発>,<業界情報>,<方針>	<技術>
給電せずに電気分解起こして高分子化合物を合成 東工大が成功	<技術開発>	<技術>
名大ら，概日リズムの精密スピード調節に成功	<技術開発>	<技術>
東洋紡が重合に成功　１００％バイオＰＥＴ樹脂	<技術開発>	<技術>
電池交換が不要なIoTシートの開発に成功	<技術開発>	<技術>
共同発表：高性能新型フェライト磁石の開発に成功–巨大な保磁力と超高周波電磁波吸収を示すハードフェライト磁石–	<技術開発>,<譲渡・買収>	<技術>,<提携>
"PIM 101 基礎講座シリーズ"　商品データを活用したマーケティング戦略を成功させるために知っておくべき 3つの常識　「第一回講座：情報の一元管理はゴールではない」	<イベント>	<イベント>
肺に核酸医薬を届ける「ナノカプセル」の開発に成功	<技術開発>	<技術>
水上ドローンで藻場の撮影に成功！操作は簡単、スマホだけ。KDDI総合研究所	<技術開発>	<技術>
Snyk、企業の DevSecOps 推進を成功に導く新機能を発表	<技術開発>	<技術>
クラウド推進の取り組みを一元化するCCoE、成功に必要な要素は（後） - クラウド推進の取り組みを一元化するCCoE、成功に必要な要素...：Computerworld		
エクソソームを用いた血液検査でパーキンソン病と多系統萎縮症の識別に成功 - バイオマーケットjp	<技術開発>	<技術>
Firefly Alphaが初の打ち上げに成功と発表、衛星は予定の軌道に乗らず? |  財経新聞	<レビュー>	<レビュー>
5Gの高信頼低遅延通信URLLCを活用し、ヒトの手を動かして感じ取れる手応えをロボット上で再現することに成功－日本初、慶大の独自技術「リアルハプティクス」をモバイルデータ通信で実現－：[慶應義塾]	<利用・採用>,<技術開発>	<技術>
水溶液から成分や物質を高効率で抽出東芝が新しい浸透圧物質の開発に成功 | 電波新聞デジタル	<技術開発>	<技術>
組織変革を成功に導く秘訣は共感力にある	<コラム>	<オピニオン>
呼気中アセトンガス、紫外光で高感度検出に成功－東北大	<技術開発>	<技術>
全固体電池の実用化に大きく前進	<研究>,<業界情報>	<技術>
～高いイオン伝導度と優れた耐水性を兼ね備えた「窒素含有硫化物固体電解質」の開発に成功～	<技術開発>	<技術>
「水道水」でサーモンの養殖に成功　大注目の『陸上養殖』の技術とは？	<技術開発>,<レビュー>	<技術>,<レビュー>
脳の「怒り」のメカニズムのパターン化に成功　機械学習活用で |  財経新聞	<技術開発>,<利用・採用>	<技術>
ユニファイドコマースで結局何ができるのか？　成功企業に学ぶ“顧客体験の劇的な改善”（ITmedia ビジネスオンライン）	<レビュー>,<技術開発>	<技術>,<レビュー>
東北大・日本製鋼所・三菱ケミ、高品質ＧａＮ単結晶の作製成功		
HVPE法で6インチウエハーに酸化ガリウム成膜世界初、NCT、大陽日酸などが成功 | 電波新聞デジタル	<技術開発>	<技術>
リテールの成功法則が変わった!? デジタルシェルフ獲得競争に勝ち残れ!!｜ECのミカタ	<レビュー>	<レビュー>
ソフトバンクら、ワイヤレス電力伝送の機能を実装したシステムの開発と実験に成功─完全ワイヤレス社会の実現へ一歩 | 知財図鑑	<技術開発>	<技術>
Apple Watchが将来搭載と噂のマイクロLEDディスプレイ〜AUOが小型化成功（iPhone Mania）	<技術開発>	<技術>
ＬＬＴＯ単結晶のイオン伝導度、多結晶体の４倍に　ＪＦＣＣが測定成功	<技術開発>	<技術>
高機能な有機ケイ素材料の製造に適した鉄錯体触媒の開発に成功--空気中で安定な鉄触媒として東京化成工業から発売--北里大学	<技術開発>,<商品化>	<技術>,<製品サービス>
3次元網目構造を有する次世代の多孔質材料『TUS-84』の創製に成功<br>～物質の吸着と放出を自在に制御可能、薬剤送達などへの応用に期待～｜東京理科大学	<技術開発>	<技術>
【マーケ・広報向けプロマネ導入セミナー/ご好評につき再開催】プロジェクトを成功させる「プロジェクトマネジメント力」を10のステップと3つのポイントで解説：時事ドットコム	<イベント>,<説明>	<イベント>,<レビュー>
【アメリカ】宝石ベンチャー、大気回収のCO2でダイヤモンド生産に初成功。炭素回収の経済性に光	<技術開発>	<技術>
『ガンダム 水星の魔女』大成功を導いた“Twitter占拠作戦”の破壊力　明らかに不便な「毎週1話」方式が日本で好まれる理由とは《タイパよりリフレイン？》（文春オンライン）	<レビュー>	<レビュー>
京大，光で最小のマイクロ流路の作成に成功	<技術開発>	<技術>
受験を成功させるカギは、「非認知能力」にあり 「選ばれる」ではなく「選ぶ」姿勢で受験に挑む（東洋経済education×ICT）	<コラム>	<オピニオン>
宇大、赤外光による自己形成光導波路での光通信部品間の自動接続に成功	<技術開発>	<技術>
東大など、従来の10倍程度の感度を有する歪みセンサの開発に成功	<技術開発>	<技術>
液体のり成分から抗菌性フィルム、静岡理工科大学が開発に成功	<技術開発>	<技術>
千葉大など、光渦の照射で構造色を示すフォトニックリングの直接印刷に成功	<技術開発>	<技術>
ソフトバンクが成功した次世代電池「3つの新技術」を発表　リチウム金属電池や全固体電池への進化を解説 「次世代電池ラボ」も初公開 |  ロボスタ - ロボット情報WEBマガジン	<技術開発>,<説明>,<イベント>	<イベント>,<技術>,<レビュー>
発光式円偏光コンバータの開発に成功―円偏光純度と明るさを両立させる新たな円偏光生成技術として期待―	<技術開発>,<資金>,<見解>,<要望>	<技術>,<政策>,<オピニオン>
重金属を好むバクテリアを使って汚染水の浄化に成功	<技術開発>	<技術>
自己修復性を示すポリイソプレンの開発に成功	<技術開発>	<技術>
産総研：高い強誘電性を有する窒化物強誘電体の薄膜化に成功	<技術開発>	<技術>
水素燃料電池を積んだ小型機、試験飛行に成功　英（CNN.co.jp）	<技術開発>	<技術>
脳内オキシトシンを初の「見える化」　慶應義塾大学と横浜国立大学が成功	<技術開発>	<技術>
ロボットバンク株式会社が資金調達成功感謝記念イベントを開催	<イベント>	<イベント>
ナノシェルの中で金ナノ粒子が動く様子の撮影に成功 新規ヨーク-シェル型光触媒材料の機能解明に寄与	<技術開発>	<技術>
船が洋上で出すCO2ほぼ純度100％で回収に成功 装置の実用化へ一歩前進 三菱重工 | Merkmal	<技術開発>,<研究>,<業界情報>	<技術>
産総研：診断難易度が高い通常型間質性肺炎を高精度に診断する人工知能モデルの開発に世界で初めて成功		
教育研修・リスキリング成功の極意『次世代の運用管理』を解説！（デジタル・ナレッジ）	<説明>	<レビュー>
磁力でマウスを「遠隔操作」することに成功	<技術開発>	<技術>
分子を挟んだ磁気ナノデバイスにおいて室温での磁気抵抗効果の観測に成功－「ナノ科学」「スピン」「分子」が融合した新しい学際領域を切り拓く－：[慶應義塾]	<技術開発>	<技術>
人工衛星間のレーザー通信実験に成功――地上局不要の相互通信を実現	<技術開発>	<技術>
FRONTEO、人の行動の機微を捉えるAIアルゴリズムの改良に成功	<技術開発>	<技術>
目に見えない静電気を分子レベルで観測することに成功	<技術開発>,<研究>	<技術>
「マテリアルズ・インフォマティクス」に関する企業動向、成功事例、ビジネスモデルをまとめた最新版調査レポートの販売をIDTechExが開始しました。	<サービス開始>,<商品化>	<製品サービス>
