ネオがんもどき「ギャンモ」4月3日発売、国産丸大豆使用の“全く新しい大豆食品”/日本ソイフードマイスター協会×エヌ･ディ･シー | 食品産業新聞社ニュースWEB	<商品化>,<生活>	<製品サービス>
ハチ食品 レトルトカレー、高価格帯へシフト 「一貫製造の強み生かす」高橋社長 - 食品新聞 WEB版（食品新聞社）	<生活>,<戦略>,<方針>,<コラム>	<tab不明-オピニオン>
韓国の20～40代、大腸がんの発病率は世界1位…食・生活習慣に課題	<コラム>,<業界情報>,<レポート>,<社会問題>	<経済>
2月のファッション小売り商況　後半気温が上がり、春物の売れ行き好調 | 繊研新聞	<自然環境>,<市場動向>	<経済>
ニッスイ、企業広告第3弾を放送開始 - 日本食糧新聞電子版	<イベント>	<イベント>
丸亀製麺がAIで需要予測、脱炭素にも	<予測>,<社会問題>	<社会>
YKKは好調から一転、下期失速、1.7％の減益　期初見通しを大きく下回る　23年3月期（WWDJAPAN.com）	<業績>,<社会統計>,<コラム>	<経済>
デジタル家電市場に「値上げ」の影　回復のカギは「リアル店舗」の巻き返し - BCN＋R	<市場動向>,<コラム>	<経済>
罪悪感ナシで毎日飲める「自然派エナジードリンク」、ポッカサッポロのこだわりとは（Impress Watch）	<コラム>	<tab不明-オピニオン>
月桂冠「生酒」を一新　冷やすと旨さが際立つ、“生”ならではのコクと香り：時事ドットコム	<サービス更新>,<コラム>	<製品サービス>
適量の水を飲むと長生きと病気の予防につながる！最新の研究で判明（ELLE DIGITAL）	<生活>,<コラム>,<技術開発>	<技術コラム>
ギフトホールディングス　2023年10月期2月度直営店売上速報、全店で前年同月比45.0％増 |  財経新聞	<市場データ>,<技術開発>,<業績>	<経済>
「ど冷えもん」ポイントは商品力	<コラム>	<tab不明-オピニオン>
資金調達支援を専門に行うSoLabo、アリババ株式会社と連携し、国内の食品製造・加工業者向けに海外展開を見据えた新たな支援を開始	<支援>,<提携>	<経済>
米大手スポーツ用品・靴メーカーの22年10～12月決算　増収基調も収益力厳しく | 繊研新聞	<業績>	<経済>
今すぐ成長軌道に乗れる「売る力倍増手法」　飲食店の経営者向け業績アップセミナー、東京で4月19日開催｜企業リリース｜徳島新聞デジタル	<コラム>,<セミナー>	<イベント>
【教員の「こころ」を守る（2）】教職員の精神疾患による病気休職者数が過去最多に	<コラム>,<社会統計>	<社会>
体力“見える化”へ世界初の新技術　ファンケルが実用化向け検証　医療やスポーツ、幅広い分野での応用期待 - トピックス｜Infoseekニュース	<技術開発>,<研究>,<調査>	<技術レポート>
矢野経済研究所、敏感肌化粧品市場に関する調査結果を発表｜週刊粧業オンライン	<市場動向>,<調査>,<技術開発>,<情報公開>,<レポート>,<方針>,<設備投資>	<経済>
クラウドファンディング開始：農業シーンの課題を解決する「新潟大学デジタル農場」はじめの一歩！ | トピックス | ニュース - 新潟大学	<コラム>	<tab不明-オピニオン>
オルビス、流通センターに最新の自律走行搬送ロボットを導入｜週刊粧業オンライン	<方針>,<利用・採用>,<設備投資>	<経済>
スタイリングライフHD「フードロス削減BOX」を導入　従業員の福利厚生と環境意識向上へ	<方針>,<利用・採用>,<技術開発>,<目標>	<技術トピック>
三省製薬、日立らとデジタル活用の店舗出店--AIアバターが製品を提案	<サービス開始>,<提案>	<製品サービス>
厚労省、レクメドの先天性胆汁酸代謝異常症治療薬など8品目の承認を了承	<政府>,<政府・認可>	<政治>
大手電力会社の値上げなど、物価高が続く新生活。リユースや訳あり食品、クレカでおトクに値上げの春を乗り切る	<業界情報>,<コラム>	<経済>
プレスリリース・タイトルリスト　2023/03/06｜薬事日報ウェブサイト	<レポート>	<tab不明-レポート>
身体にも環境にもやさしい 新しい植物性ミルク岩手県産雑穀（※1）１００％使用「雑穀ミルク∼milletmilk∼」２０２３年３月６日より全国で新発売	<コラム>,<紹介>,<商品化>	<製品サービス>
2022年国内PC出荷は11％減、「DXで競争力強化」は3年後でも1割未満、PPAP対策が遅れる業種、ほか	<社会統計>,<市場データ>	<経済>
えっ…アルコールに頼る若者が増加？医師が教える「お酒の本当の“適量”」とは	<社会統計>,<現象>,<コラム>	<社会>
ポーラ・オルビスHD、「アンプリチュード」「イトリン」の販売終了｜週刊粧業オンライン	<サービス終了>,<商品化>,<設備投資>	<製品サービス>
伊藤忠商事　改革断行。朝型勤務で出生率が上昇 | 繊研新聞	<社会統計>	<社会>
認知症研究30年超の私が、パンや麺を食べたくなったら【書籍オンライン編集部セレクション】	<コラム>	<tab不明-オピニオン>
ティッシュペーパー市場の新たなトレンド、需要の増加、売上高、予測2022年から2028年【Ameliorate Digital Consultancy Private Limited】｜小売業界（スーパー・コンビニ・百貨店）の最新情報｜ニュース｜フーズチャネル	<市場動向>,<業績>,<予測>	<経済>
人口減少が加速する日本、今必要なことは｜薬事日報ウェブサイト	<コラム>	<tab不明-オピニオン>
【トップは語る】ＳＢＩ生命保険社長・小野尚さん（６３）　新生銀と連携　団信で相乗効果期待	<コラム>,<提携>,<見解>,<要望>	<経済>
「アンプリチュード」「イトリン」ブランド終了　特別損失約8億円（WWDJAPAN.com）	<サービス終了>,<業績>,<投資>	<製品サービス>
＜４月は食道がん啓発月間／特別講演に女優 秋野暢子 氏＞無料市民公開講座「知って備えて・学んで予防　正しく知ろう食道がんの事」▼２０２３年４月２３日（日）：国立...	<コラム>	<tab不明-オピニオン>
知らぬ間に血圧を上げている、毎日の「あるある」集（ウィメンズヘルス）	<方針>,<コラム>	<tab不明-オピニオン>
ケンタッキーが８日から値上げ、オリジナルチキンは３０円アップ（Lmaga.jp）	<価格変更>	<製品サービス>
マーケターこそデザインファームに学べ　デザイン思考に5つの誤解	<コラム>	<tab不明-オピニオン>
ネクストミーツ、コストコ全店で大豆ミート　家庭への代替肉普及狙う - 日本食糧新聞電子版	<コラム>	<tab不明-オピニオン>
【PR】 カーボン･ニュートラル実現、 “2027年まで”に	<情報提供>,<技術開発>,<コラム>	<経済>
出店店舗の売上促進に寄与する「楽天市場」広告の取り組み[インタビュー]	<紹介>	<tab不明-トピック>
富士山エリアを環境と観光の調和の取れたリゾートシティとして開発 ―― 富士急行株式会社	<技術開発>	<技術トピック>
乳酸菌プレミアム　酸化防止剤無添加　ポリフェノールリッチ新発売	<商品化>	<製品サービス>
【第154回】D Capitalが描く「おやつカンパニー」の成長加速戦略	<コラム>,<方針>,<業界情報>	<経済>
韓国初、ファブレスのスタートアップがユニコーン	<市場動向>	<経済>
【2022年度総括】OSグループ健康経営の取り組みについて	<コラム>	<tab不明-オピニオン>
PRESS RELEASE2023 年 3 月 6 日 
東京大学 
北里大学高齢急性心不全患者にも	<コラム>	<tab不明-オピニオン>
「第2回日経統合報告書アワード」でグランプリを受賞	<表彰>	<社会>
「大事なところに線を引く」「語呂合わせで覚える」といった学習方法は本当に効果的なのか？	<コラム>	<tab不明-オピニオン>
2/27-3/5 資金調達を実施したプロジェクト 7選	<戦略>,<資金>,<紹介>,<レポート>	<経済>
「Bing」の新しいAI機能を組み込んだ「Skype」が登場 ～「Skype Insider」でテスト開始／アニメーション付きの新しい起動ロゴやMacの「Touch Bar」対応拡充も	<商品化>,<実験>,<技術開発>	<製品サービス>
「GEOTRA Activity Data」に訪日外国人（インバウンド）行動データを搭載	<技術開発>	<技術トピック>
いかにしてインドは電子決済大国へと変身を遂げたのか？	<コラム>	<tab不明-オピニオン>
AIリスクを解決するRobust Intelligence Co-Founder：大柴 行人が自民党「AIプロジェクトチーム」勉強会で「攻めのAIガバナンス」について講演	<セミナー>	<イベント>
【画像/動画】「ウクライナ操縦士」がF16訓練開始！のスクープから中国メディアの詳細リポートまで	<コラム>	<tab不明-オピニオン>
複数のストリートブランドを展開するyutoriのECサイト「YZ STORE」がサイト内で動画コマースの活用開始｜LEEEP	<技術開発>,<利用・採用>,<サービス開始>	<製品サービス>
AIでビデオを鮮明に ～「Micorosoft Edge」に「超解像度ビデオ」機能が導入へ／Canaryチャネルの半数に提供中	<商品化>	<製品サービス>
AWS Graviton で EC2 コストを40%削減。国内最大級メタバース運営 クラスター社の AWS 活用	<技術開発>,<利用・採用>	<技術トピック>
マウザー、TE Connectivityと共同でフリートテレマティクスの設計問題を深く掘り下げた新しいeBookを発表		
ためになる3Dグラフィックスの歴史(3)。テクスチャフィルタリング技術最適化の乱（Impress Watch）	<コラム>	<tab不明-オピニオン>
【Qlipperランキング】SDGs・ESG・サステナビリティ ウェブニュースランキング（2023年2月）	<レポート>,<技術開発>	<技術レポート>
クラウドファンディング開始：農業シーンの課題を解決する「新潟大学デジタル農場」はじめの一歩！ | トピックス | ニュース - 新潟大学	<コラム>	<tab不明-オピニオン>
持続可能な未来を描く「そろばん教育」	<コラム>,<方針>	<tab不明-オピニオン>
実績に基づいたベストプラクティスでお客様のクラウド移行の課題を解決したい--ユニアデックスがSpecialization取得を目指した理由	<コラム>,<政府・認可>,<時制.未来>	<政治>
Oasysとパートナーシップ契約を締結！～Oasys上で独自Verse、「CAICA Verse」を立ち上げ～	<契約>,<受注>,<方針>	<製品サービス>
「GoodNotesでトレース!?」amity_sensei⁠流ノ⁠ー⁠ト術がさすが！ (1/2)	<コラム>	<tab不明-オピニオン>
サムスンもいよいよ？ リングやVRヘッドセットに乗り出すかも	<コラム>	<tab不明-オピニオン>
コインベースのレイヤー2「Base」NFT、48万個以上が生成	<技術開発>	<技術トピック>
バイナンスが法執行機関と協力して詐欺防止キャンペーン開始	<提携>	<経済>
25年前にApple Newton製品の終了が発表されました：路の上で：オルタナティブ・ブログ	<商品化>,<サービス終了>,<コラム>	<製品サービス>
A17 Bionicの性能に追いつくのは困難か〜Snapdragon 8 Gen 3	<技術開発>,<コラム>	<技術コラム>
Verbatim、製品出荷時に⾼温環境にて全数試験を実施した「⾼速＆⾼信頼性SSD」（2TB）を発売	<イベント>,<実験>,<商品化>	<製品サービス>
4nmプロセス採用の5Gスマートフォン向けSoC		
イートンの可変バルブ駆動技術が最近のテストで劇的な排出削減を達成：時事ドットコム	<技術開発>	<技術トピック>
Ruby on Railsコミッター 松田明氏がファーエンドテクノロジーの技術顧問に就任、松田氏の技術支援によりRedmineへの貢献を加速	<人事>,<支援>,<説明>,<技術開発>	<経済>
Chromebookはビジネスでどこまで使えるか？(10) GoogleカレンダーでMicrosoftとAppleのカレンダーを使う方法	<技術開発>,<コラム>	<技術コラム>
無料の高機能パケット解析ツール「Wireshark 4.0.4」が公開（Impress Watch）	<商品化>,<技術開発>	<製品サービス>
AIG女子オープンへの協賛	<支援>	<経済>
AI技術の可能性は「予測」を超える 意思決定の改善から組織や社会の変革へ | アジェイ・アグラワル,ジョシュア・ガンズ,アヴィ・ゴールドファーブ | ["2023年4"]月号｜DIAMOND ハーバード・ビジネス・レビュー	<業界情報>,<社会統計>,<コラム>,<行動変化>,<目標>,<レポート>	<経済>
【産業動向】米、台中禁輸リストにサーバーInspurやネットワークスイッチCentec　影響懸念の台湾4社 - EMSOne中国電子・電気・通信市場情報からEMS情報まで毎日更新！ - www.emsodm.com	<提携>,<サービス更新>	<製品サービス>
IoT向けLinux OSと認証局、セキュアIoT認定のGoldを取得	<政府・認可>	<政治>
【少子高齢社会における重要課題】「親の介護を子どもが担うのは当たり前か？」介護・暮らしジャーナリスト 太田差惠子氏執筆の新イシュー。Surfvoteで投票開始	<コラム>,<社会問題>,<レポート>	<社会>
Feelnote、「ポートフォリオAI分析機能」の新機能を搭載（Impress Watch）	<技術開発>	<技術トピック>
偉人は、世界を見る「まなざし」をアップデートする	<技術開発>,<コラム>,<サービス更新>	<製品サービス>
北九州市が後援する学生向けインターネットインフラハッカソン「DevSecOpsThon at GMO kitaQ」を今年も開催！	<イベント>	<イベント>
チェック・ポイント、最高のセキュリティと最適化されたインターネット接続を実現するブランチオフィス保護ソリューション、Quantum SD-WANを発表	<技術開発>	<技術トピック>
「Windhawk」でWindows 11の仮想デスクトップ＋タスクバーのイライラを解決可能に（Impress Watch）	<技術開発>	<技術トピック>
無料配布資料「CMS導入・リプレイスのよくある質問と解決案一覧」の提供を開始しました！【LeadGrid】	<サービス開始>,<技術提供>,<コラム>	<製品サービス>
LNGCON 2023：メタン電解でLNGをCO2フリー水素に変換：時事ドットコム	<技術開発>	<技術トピック>
パウエルＦＲＢ議長、タカ派メッセージ発信か－追加利上げの地ならし	<コラム>	<tab不明-オピニオン>
世界に278名のKaggle Grandmasterがアイリス株式会社から2名同時に誕生	<コラム>,<サービス開始>	<製品サービス>
PHPの関数とメソッドは別物	<技術開発>,<コラム>	<技術コラム>
Oasys、ゲームトークン特化のZaifと提携	<提携>	<経済>
「Veeam Backup for Microsoft 365 v7」提供開始、不変コピー保存可能に	<商品化>,<技術開発>	<製品サービス>
ソフトバンクG傘下アーム、米ＩＰＯで少なくとも80億ドル調達目指す－報道	<資金>,<コラム>,<時制.未来>	<経済>
Vivaldiブラウザーがフォルクスワーゲンの車載情報システム向けのアプリストアに搭載	<技術開発>	<技術トピック>
メタバース向け3D画像生成ツール「Hexa」が28億円調達 | Forbes JAPAN 公式サイト（フォーブス ジャパン）	<資金>	<経済>
Arm、Apple Mのシングルスレッド性能に追い付くべく新Cortex-Xを開発中	<技術動向>,<技術開発>	<技術トピック>
EV対応のスキャンツールなど、ツールプラネットがIAAE 2023に出展へ（レスポンス）	<イベント>	<イベント>
マウザー、TE Connectivityと共同でフリートテレマティクスの設計問題を深く掘り下げた新しいeBookを発表		
ZTEとAISが世界初のアイウエアフリー3D･AIタブレットを共同発表し、MWC 2023で覚書を締結	<コラム>,<技術開発>,<契約>,<受注>	<製品サービス>
AWS Graviton で EC2 コストを40%削減。国内最大級メタバース運営 クラスター社の AWS 活用	<技術開発>,<利用・採用>	<技術トピック>
メタバース向け3D画像生成ツール「Hexa」が28億円調達 | Forbes JAPAN 公式サイト（フォーブス ジャパン）	<資金>	<経済>
トレーラの位置情報を取得し管理可能となる新サービス、ドコマップ	<サービス開始>,<商品化>,<レポート>	<製品サービス>
PALTEK、ゼット・エフ・ジャパン、2社と連携した新サービス　「docomap Trailer」がいよいよ一般向けにサービス開始	<提携>,<サービス開始>,<商品化>	<製品サービス>
ニュース | Page 1429 of 1429 | OPTRONICS ONLINE　オプトロニクスオンライン	<設備投資>	<経済>
5Gの収益と資本の効率化に向けた多様なルートが明らかに	<情報公開>,<コラム>	<経済>
世界最先端！ChatGPT API[gpt-3.5-turbo]搭載 CalqOffer無料提供スタート！求人票作成の手間を大幅削減：時事ドットコム	<コラム>,<技術開発>,<サービス開始>	<製品サービス>
イートンの可変バルブ駆動技術が最近のテストで劇的な排出削減を達成：時事ドットコム	<技術開発>	<技術トピック>
サムスンもいよいよ？ リングやVRヘッドセットに乗り出すかも	<コラム>	<tab不明-オピニオン>
xID、FIN/SUM 2023『フィンテックスタートアップコンテスト』の一次選考を通過	<表彰>	<社会>
ナレッジワーカーのためのセカンド・ブレイン・ソフトウェアを開発するmindbento株式会社に出資	<政府・補助金>,<支援>,<投資>	<政治>
みんなの銀行、SaaSセキュリティ状況管理ツールを導入	<方針>,<利用・採用>	<技術トピック>
米メタ、ＶＲヘッドセット値下げ　顧客取り込みへ	<価格変更>,<目標>	<製品サービス>
チェック・ポイント、最高のセキュリティと最適化されたインターネット接続を実現するブランチオフィス保護ソリューション、Quantum SD-WANを発表	<技術開発>	<技術トピック>
ChatGPTでSQLを自動生成する「SQL AI アシスタント」、DB管理画面のローコード開発ツール「Dashcomb」に追加 | IT Leaders	<サービス開始>	<製品サービス>
「AIアナウンサー®GPT」（β版）の無料提供を開始	<サービス開始>	<製品サービス>
GA Telesisと東京センチュリーが、航空機の直接貸付プラットフォームHALO AirFinanceの提供開始を発表	<サービス開始>,<技術提供>	<製品サービス>
AIO Core、業界初量子ドットレーザベースSiPhトランシーバチップ | e.x.press		
セカンドブレイン・ソフトウェアのmindbentoがスパークル、MIRAISEから2,000万円の資金調達を実施	<イベント>,<資金>	<経済>
Feelnote、「ポートフォリオAI分析機能」の新機能を搭載（Impress Watch）	<技術開発>	<技術トピック>
コンテナ開発の「Moby」v23やコマンドラインAI画像作成「DalleCLI」v1.0など - 2023年2月のGitHub Release Radar		
北九州市が後援する学生向けインターネットインフラハッカソン「DevSecOpsThon at GMO kitaQ」を今年も開催！	<イベント>	<イベント>
エリクソンがABI Researchのサステナビリティ評価でリーダーに選定	<表彰>	<社会>
ＶＷ傘下スカウト、サウスカロライナ州に20億ドルでＥＶ工場新設へ	<設備投資>,<目標>	<経済>
IoT向けLinux OSと認証局、セキュアIoT認定のGoldを取得	<政府・認可>	<政治>
AIリスクを解決するRobust Intelligence Co-Founder：大柴 行人が自民党「AIプロジェクトチーム」勉強会で「攻めのAIガバナンス」について講演	<セミナー>	<イベント>
AIへの関心高まる--O'Reilly「2023年テクノロジートレンド」	<コラム>	<tab不明-オピニオン>
ボルボ・バス、マレーシアで現地組立の「B11R」ローエントリーダブルデッカー披露	<情報公開>	<経済>
メンテナンスフリーの屋内外位置トラッカーを開発（EE Times Japan）	<技術開発>	<技術トピック>
Casela Technologies、高出力外部レーザ光源モジュールデモ | e.x.press	<実験>	<技術トピック>
無人拠点や遠隔地にある機器のリモート保守を実現、IoT向けLTEルーターをSORACOM IoTストアで提供開始	<技術開発>,<サービス開始>,<技術提供>	<製品サービス>
プリファード西川CEOが語る深層学習の進化、教育事業にも注力	<コラム>,<技術動向>,<業界情報>	<経済>
Novata、約40億円を調達	<資金>	<経済>
国内CCaaS市場でシェア30％を目指す--ナイスジャパンのジオレット社長	<方針>,<目標>,<コラム>	<tab不明-オピニオン>
無料配布資料「CMS導入・リプレイスのよくある質問と解決案一覧」の提供を開始しました！【LeadGrid】	<サービス開始>,<技術提供>,<コラム>	<製品サービス>
令和トラベル、国内最大級のスタートアップカンファレンスIVSと業務提携	<提携>	<経済>
DXへ直結するITインフラを実現するための最新戦略と手法とは	<コラム>	<tab不明-オピニオン>
【産業動向】米、台中禁輸リストにサーバーInspurやネットワークスイッチCentec　影響懸念の台湾4社 - EMSOne中国電子・電気・通信市場情報からEMS情報まで毎日更新！ - www.emsodm.com	<提携>,<サービス更新>	<製品サービス>
LINE決済管理サービス「サブスクライン」がChatGPT APIと連携　LINEの自動応答をChatGPTで実現！今までにない顧客体験を提供します。	<提携>,<技術開発>,<技術提供>,<サービス開始>,<コラム>	<製品サービス>
話題のChatGPTを「Google スプレッドシート」に組み込んでヘルプを作ってみた（Impress Watch）	<コラム>	<tab不明-オピニオン>
Current Trucking、Ares Managementから約340億円の資金調達	<資金>	<経済>
SAP Concur ナビゲーション「N ナビ」による操作誘導		
ESGをビジネスモデルに組み込む6つのステップ 財務目標と切り離された現状を見直す | マーク R. クラマー,マーク W. フィッツァー | ["2023年4"]月号｜DIAMOND ハーバード・ビジネス・レビュー	<コラム>,<レポート>	<tab不明-オピニオン>
NTTエレクトロニクス、140Gbaud対応の高性能コヒーレントDSPを販売開始 - 日本経済新聞	<サービス開始>,<市場動向>	<製品サービス>
ChatGPT＋3Dモデルの音声対話エージェントを15分で開発する方法	<技術開発>,<コラム>	<技術コラム>
「GEOTRA Activity Data」に訪日外国人（インバウンド）行動データを搭載	<技術開発>	<技術トピック>
TSとGNSSに対応した統合型データコレクタ用アプリケーション「プロサーベイヤー3D」発売 | サポーターズ・コーナー	<商品化>	<製品サービス>
住友ゴム、タイ工場を太陽光発電で電力ゼロカーボン化 – 日刊ケミカルニュース	<技術開発>	<技術トピック>
EVシフト「部品点数」激減で、部品メーカーの生き残り合戦が始まった！ 愛知のホンダ系企業が選んだ「社員を生かす」道とは | Merkmal（メルクマール）	<コラム>,<戦略>,<方針>	<tab不明-オピニオン>
電気や水がいらない移動式住宅、無印良品が実証実験	<実験>	<技術トピック>
ＪＦＥシステムズ、ＪＦＥスチール「製鉄所における燃料・電力運用ガイダンスシステム」のエネルギー需給予測モデル、燃料・電力シミュレーションの開発に参画｜企業リリース｜徳島新聞デジタル	<サービス開始>	<製品サービス>
世界のＣＯ２排出量が22年に過去最高水準に増加、欧州減でも－ＩＥＡ	<社会統計>,<現象>	<社会>
【人気モデル 購入最前線】ホンダ フィット編（2023年3月）（WEBヤングマシン）	<コラム>	<tab不明-オピニオン>
【先進原子炉実証 】ダウとX-エナジー、初の先進小型モジュール原子炉を工業地に配備する計画を発表	<実験>,<方針>,<目標>,<戦略>	<技術トピック>
有機EL「再結合」過程観測、大阪公立大などが成功した意義 ニュースイッチ by 日刊工業新聞社	<技術開発>,<研究>	<技術トピック>
レクサスLFAやインプレッサ22Bなど…国産車のユニークな限定生産車4選	<紹介>,<レポート>,<生産活動>	<製品サービス>
原子力機構、薄膜磁石の基礎原理解明　デバイス小型化に重要 ニュースイッチ by 日刊工業新聞社	<技術開発>,<コラム>	<技術コラム>
新型プリウスに標準搭載の先進安全機能の凄さ　割り込まれたら自動減速、あおり運転には通報支援（マネーポストWEB）	<社会情勢>,<支援>	<経済>
中国、石炭の補助的役割拡大へ　エネルギー安全保障巡る取り組みで	<方針>,<目標>,<海外展開>,<紹介>	<経済>
体力“見える化”へ世界初の新技術　ファンケルが実用化向け検証　医療やスポーツ、幅広い分野での応用期待 - トピックス｜Infoseekニュース	<技術開発>,<研究>,<調査>	<技術レポート>
【3月23日（木）ハコベルウェビナー開催】ラストマイル配送車を皆でEV化、脱炭素物流と災害支援を両立！？	<セミナー>,<技術開発>,<効果>,<コラム>	<イベント>
JFE条鋼、鹿島で太陽光PPA導入（日刊産業新聞）	<方針>,<利用・採用>	<技術トピック>
ホンダ「シビック」ターボ＆ハイブリッドの受注停止！「タイプR」続きシビックシリーズに何があった？（くるまのニュース）	<障害>,<サービス終了>,<業界情報>,<コラム>	<製品サービス>
「燃費バグってる？」 トヨタ新型「プリウス」の実燃費は“バイク並み”？ 圧倒的“低燃費”性能が話題に - トピックス｜Infoseekニュース	<コラム>	<tab不明-オピニオン>
東京建物、2030年度までに保有ビルを100%再エネに - 日経GX		
4代目プリウス購入者｢60代以上が過半数｣の事実	<コラム>	<tab不明-オピニオン>
光照射による固体からの電子取り出し精度は1nm以下		
ＩＨＩ、グリーンアンモニア製造でインドネシア国営企業とＦＳ | 電気新聞ウェブサイト		
「緑の重商主義」が世界を覆う：日本は20兆円「GX経済移行債」で何を目指すか（新潮社 フォーサイト）	<コラム>,<方針>,<目標>	<tab不明-オピニオン>
身に着ける投資、7879の純金属ジュエリーが示す未来 | Forbes JAPAN 公式サイト（フォーブス ジャパン）	<投資>,<技術開発>,<コラム>	<経済>
国土交通省｜報道資料｜路面太陽光発電技術に関する公募を開始します<br>～道路でエネルギーを創出し、再エネのさらなる活用を目指します～	<政府>,<情報公開>,<コラム>,<技術開発>,<利用・採用>	<政治>
データセンター内のサーバーを液体冷却、冷却電力の94%減を達成	<技術開発>	<技術トピック>
アペルザTVオンデマンドウェビナー『「圧縮空気」の見える化で工場の省エネ目標達成、電気代削減を実現！』配信中です！ | 株式会社オーバル	<セミナー>,<コラム>	<イベント>
独緑の党はどこに行く	<コラム>	<tab不明-オピニオン>
JALが実用化へ、航空機エンジン故障をAI予測の仕組み ニュースイッチ by 日刊工業新聞社	<技術開発>,<目標>,<コラム>	<技術コラム>
丹羽鋼業、太陽光発電を設置　電気代65％減	<組織>,<設備投資>,<市場データ>	<経済>
ファーウェイが「PV Expo」に中規模産業用蓄電池など出展 | 電波新聞デジタル	<イベント>	<イベント>
化学の力で廃プラ問題に答えを。社外ベンチャーとの共創で社会課題の早期解決へ | レゾナック	<コラム>,<目標>	<tab不明-オピニオン>
世界の石油投資、及び腰が拡大　新興国1.7億人「エネルギー貧困」 - 日本経済新聞	<投資>,<方針>,<コラム>,<社会問題>,<市場動向>	<経済>
三洋貿易、中規模の木質チップバイオマス発電装置 - 日経GX	<市場動向>,<技術開発>	<経済>
千里ライフサイエンスセミナーV1『相分離がもたらす医療・創薬の新展開』１．  日時：２０２３年５月２	<セミナー>,<業界情報>,<方針>	<経済>
ガラス製造にアンモニア　AGC実験 - 日本経済新聞	<実験>,<市場動向>	<経済>
世界を揺るがす中国新興EVブランド「Zeekr」の野心　あと2年で年間65万台へ	<目標>	<tab不明-トピック>
筑波大学などが100％液体のレーザー光源、イオン液体に色素添加		
神経科学と生成系AIの共進化｜Koji Fukuoka｜note	<コラム>,<技術動向>,<技術開発>	<技術コラム>
「中古は2018年式以降を狙え」ランクルプラドの賢い売り時と確実に得する買い方!!（ベストカーWeb）	<コラム>	<tab不明-オピニオン>
日本市場は捨てていない！3代目ルノー カングーの全方位的進化は実は悩ましい（小沢コージ）（日刊ゲンダイDIGITAL）	<方針>,<コラム>,<障害>	<社会>
次世代エアモビリティを開発・製造する「Volocopter GmbH」との資本業務提携について | 積水化学工業株式会社	<コラム>	<tab不明-オピニオン>
日揮、温暖化ガスのメタンの漏れ検知　茨城に評価設備 - 日本経済新聞	<技術開発>,<設備投資>,<市場動向>	<経済>
実験モジュール「夢天」、燃焼実験キャビネットが初の点火実験に成功―中国	<実験>	<技術トピック>
サーキュラ―エコノミーが「国際規格化」へ、ISO/TC323とは（オルタナ）	<技術開発>,<目標>,<コラム>	<技術コラム>
東北電、工場の生産設備異常を早期検知　来月から全国展開	<技術開発>,<業界情報>,<方針>	<経済>
PHEVがまもなく発売！ トヨタ『プリウス』新型まとめ | レスポンス（Response.jp）	<商品化>,<コラム>	<製品サービス>
【PR】 カーボン･ニュートラル実現、 “2027年まで”に	<情報提供>,<技術開発>,<コラム>	<経済>
都内サービスステーション（ガソリンスタンド）でユーグレナ社の次世代バイオ燃料を一般向けに販売開始	<譲渡・買収>,<サービス開始>	<製品サービス>
名大，究極の薄さのアモルファスシリカを合成 | OPTRONICS ONLINE　オプトロニクスオンライン	<技術開発>,<設備投資>	<経済>
塗膜に微細構造施し重量軽減　JAL、JAXAなど４者が新技術　燃費改善で脱炭素化にも貢献 | 電波新聞デジタル	<技術開発>,<説明>	<技術トピック>
低栄養・フレイル・サルコペニアを「食事」で予防・対策 医師がWeb連載する「パワーアップ！食と健康」3/8スタート【ファンデリー】｜小売業界（スーパー・コンビニ・百貨店）の最新情報｜ニュース｜フーズチャネル	<対策>,<サービス開始>	<製品サービス>
炭酸割り専用ビネガー＜クラフトジンジャー味＞（ヤマモリ）2023年2月1日発売 - 日本食糧新聞電子版	<商品化>	<製品サービス>
粧業日報2023年3月7日（第15874号）｜週刊粧業オンライン	<設備投資>	<経済>
【新刊】『認知症と脳卒中は同時に予防できる』3月8日発売！長嶋茂雄氏を脳卒中から生還させた主治医・内山真一郎教授が解説（桜の花出版）	<コラム>,<商品化>	<製品サービス>
変革への道筋　製薬トップに聞く／住友ファーマ社長・野村博氏	<コラム>,<対談>	<その他>
3月9日は「世界腎臓デー」　40代の4割以上が慢性腎臓病を知らない　腎臓を守るために何が必要？｜ニュース｜糖尿病ネットワーク	<コラム>	<tab不明-オピニオン>
ライオン、バングラデシュ合弁会社の増資引受｜週刊粧業オンライン	<設備投資>	<経済>
三井物産、花王のブラジル子会社に出資｜週刊粧業オンライン	<政府・補助金>,<支援>,<投資>,<設備投資>	<政治>
非接触・非侵襲型検査で急成長を続けている未来価値創造企業の新たな取り組みとは？	<紹介>,<コラム>	<tab不明-オピニオン>
“飲み飽きないうまさ”と“力強いコク・飲みごたえ”を両立して、キリン「本麒麟」の中味とパッケージをリニューアル発売 | THE OWNER	<効果>,<商品化>,<サービス更新>	<製品サービス>
キリン　ファイア　ワンデイ＜砂糖不使用ラテ＞（キリンビバレッジ）2023年4月11日発売 - 日本食糧新聞電子版	<商品化>	<製品サービス>
カジュアルウエアやフレッシャーズ関連好調、アパレル業界に光　外出や行事増、各社ニーズ対応（岐阜新聞Ｗｅｂ）	<技術開発>	<技術トピック>
ナッツ本来の美味しさを追求！「Kono:me（コノミィ）」3月27日発売	<商品化>	<製品サービス>
荷受扱い情報（豊洲２月）高単価品堅調で増額	<株式概況>	<経済>
製法や味付けにこだわる新ブランド「Kono:me（コノミィ）」		
卵不足、ねり業界に影響/だて巻きやおでん減産も　民間調査	<生産活動>,<調査>	<製品サービス>
2023年に最も「値上げが多かった」食品分野とは　値上げトレンド分析から見えてきた	<コラム>,<生活>	<tab不明-オピニオン>
CVCファンドを通じ、標的α線核医学治療（TAT）を応用した抗がん剤の開発を行うアルファフュージョンへ出資	<技術開発>,<政府・補助金>,<支援>,<投資>	<政治>
帝王切開で母親の育児ストレスが増加｜女性疾患・周産期｜健康・公衆衛生_小児｜医療ニュース｜Medical Tribune	<方針>,<現象>	<tab不明-トピック>
＜豆乳ときなこ＞　のふんわりバー（丸善）2023年3月13日発売 - 日本食糧新聞電子版	<商品化>	<製品サービス>
イントループは予防医療事業を展開するウェルネスホライゾン創生機構と業務協業を開始	<提携>	<経済>
カルビオスがエレン・マッカーサー財団の循環型経済ネットワークに参加し、「プラスチック廃棄物・汚染を過去のものにする」ことを目指す1：時事ドットコム		
白鶴　冷やしあまざけ（白鶴酒造）2023年2月27日発売 - 日本食糧新聞電子版	<商品化>	<製品サービス>
最高品質のコーヒーを自宅で手軽に楽しめるリキッドコーヒーがリニューアル	<サービス更新>	<製品サービス>
秋田のヤマダフーズ、ゴマの風味豊かな納豆の新商品 - 日本経済新聞	<商品化>,<市場動向>	<製品サービス>
販促施策の効果と商品価値で顧客開拓を推進する鶏肉ブランド「国産鶏肉 桜姫」 _小売・物流業界 ニュースサイト【ダイヤモンド・チェーンストアオンライン】	<設備投資>	<経済>
ファンタ　プレミア＜とろけるもも＞（コカ・コーラシステム）2023年1月30日発売 - 日本食糧新聞電子版	<商品化>	<製品サービス>
＜豆乳とカカオ＞　ふんわりバー（丸善）2023年3月13日発売 - 日本食糧新聞電子版	<商品化>	<製品サービス>
「湖池屋ストロング」3品 (3月6日発売)	<商品化>	<製品サービス>
『ティール組織』著者ラルー氏も学ぶ！ソースプリンシプル（ソース原理）＆マネーワーク提唱者ピーター・カーニック氏初来日イベント開催。公認プラクティショナーによ...	<コラム>,<イベント>	<イベント>
慶応義塾大学など、乳酸値で運動評価　心疾患患者のリハビリに - 日経テックフォーサイト	<業界情報>	<経済>
綿半HDは綿半ドラッグと連携した動物用医薬品の取扱いなど幅広くペット市場に参入 |  財経新聞	<サービス開始>	<製品サービス>
アルファフュージョン、シリーズAをファーストクローズし、アスタチン創薬を加速	<資金>,<技術開発>	<経済>
日本の10歳代女性における月経に伴う諸症状に関する実態調査(2)－月経随伴症状「下腹部痛」「眠気」「イライラ」と、PMS症状「イライラ」「食欲亢進」は、全体の6割近くが日常生活に影響あり－	<調査>,<コラム>	<tab不明-オピニオン>
アルファフュージョンが4.5億円を資金調達、 Atの安定供給は2025年めど	<資金>,<目標>	<経済>
ビジョンを起点に業務を改革--日本IBMと中外製薬が進める、生産機能のDX	<政府・行革>,<技術開発>,<コラム>	<政治>
株式会社サイフューズと日立グローバルライフソリューションズ株式会社は、MetaTech (AP) Incと台湾日立アジアパシフィック社とともに再生医療の発展を目的とする協業へ...	<イベント>,<提携>	<経済>
【市立伊丹病院】入院患者の再転倒を抑制‐薬物療法変更、医師に提案｜薬事日報ウェブサイト	<提案>	<tab不明-オピニオン>
アサヒ 颯（アサヒ飲料）2023年4月4日発売 - 日本食糧新聞電子版	<商品化>	<製品サービス>
交通新聞 電子版｜チェーンストア販売統計　２３年１月	<商品化>	<製品サービス>
豊かな麦のうまみと飲み飽きない余韻を実現、新ジャンル「アサヒ ザ・リッチ」の中味とパッケージをフルリニューアルし発売 | THE OWNER	<技術開発>,<サービス更新>,<商品化>	<製品サービス>
国が目標として掲げる「ウェルビーイング」って何？　病気があっても、虚弱でもつかみ取れる「良い生」とは	<コラム>,<政府・認可>	<政治>
クラフトコーラ専門メーカー「伊良コーラ（いよしコーラ）」から新商品『伊良コーラ』（缶タイプ）が登場！	<商品化>	<製品サービス>
岩谷産業が陸上養殖事業拡大/研究所に閉鎖循環設備導入	<方針>,<利用・採用>,<サービス終了>	<製品サービス>
発売初月に2,000食を販売した「上等カレー」の冷凍カレー　新商品が販売スタート！	<サービス開始>	<製品サービス>
話題の次世代シーフード「まるで魚」新シリーズ！プラントベースの「まるでカニカマ」を共同開発	<技術開発>	<技術トピック>
Bコープ取得企業から学ぶ社会課題解決事業の立ち上げ方	<コラム>	<tab不明-オピニオン>
Excelを用いた属人的な需給調整を、クラウド上のMySQLシステムへ変革。MySQL Database Serviceが選ばれた理由とは［PR］	<行動変化>,<情報提供>	<経済>
「ラーメン」の一風堂と幸楽苑の業績に明暗くっきり　その要因は	<コラム>	<tab不明-オピニオン>
パナソニック HDグループCIOが問い掛ける「日本企業の変革を妨げるのは何か」 | JDIR		
AIベースのコーディング支援ツール、企業向けプランの一般提供を開始	<サービス開始>	<製品サービス>
「ThreaX／Azure RTOS」の悔恨から生まれた「PX5 RTOS」はできたてほやほや	<コラム>	<tab不明-オピニオン>
「開発の民主化」を掲げ、日本での展開を本格化--コヒーレントのブリスコCEO	<技術開発>,<海外展開>	<経済>
会話AI技術をTutorial Englishに採用	<利用・採用>	<技術トピック>
Mapboxとトヨタ モーター ヨーロッパが提携し、Yaris、Yaris Cross、Aygo X車向けにクラウドナビゲーションを開始	<提携>,<サービス開始>,<技術開発>	<製品サービス>
【校閲クイズ】「剛腕といわれる彼の強行なやり口に翻弄される」。この文章のどこが誤っているか、わかりますか…？ （講談社校閲部） @gendai_biz	<コラム>	<tab不明-オピニオン>
Mouseflowが、2023年「世界のTOP50プロダクト」に選出！	<表彰>	<社会>
MAPXUSとNOIZが世界初の屋内ロケーションベースのGAMEFIメタバース構築へ	<設備投資>,<目標>	<経済>
【プレゼント企画】EaseUS公式Twitterにてキャンペーン開始！	<イベント>	<イベント>
Ayar Labs、業界初4-Tbps光ソリューションをデモ | e.x.press	<実験>	<技術トピック>
危険なショッピングサイトを即確認「SAGICHECK」が日本語サイトに対応 ～ JC3 情報提供（ScanNetSecurity）	<技術開発>,<調査>,<技術提供>,<サービス開始>	<製品サービス>
「Windows Insider Program」に「Canary」チャネルが新設	<設備投資>	<経済>
2023年3月15日（水）　ブラックマジックデザイン新製品展示会開催！ @パンダスタジオ浜町	<イベント>	<イベント>
オールインワン3Dインテリアデザインツールを展開するManycore(郡核)とは？ | 建設テックメディア CONTECH MAG	<業界情報>,<方針>,<コラム>	<経済>
cTraderのChart StreamをSpotwareが実現：自分のテクニカル分析を毎日24時間配信可能：時事ドットコム	<技術開発>	<技術トピック>
メタバース、基礎を理解する5つの疑問	<コラム>	<tab不明-オピニオン>
EdgeやChromeで使えるMicrosoftエディター、単独「たり」や「ら」抜きに警告	<業界情報>	<経済>
ミーティング後の自動要約機能を新たに実装の「One Minutes」議事録の作成時間を大幅に削減	<技術開発>	<技術トピック>
USEN-NEXT HOLDINGSとZENKIGEN、「就活維新 -RecruiTech® for U.-」にて、動画AI解析を用いた面接官スキルの可視化に着手	<サービス開始>,<技術開発>	<製品サービス>
KDDIがメタバース・Web3サービス「αU」開始、Google CloudのImmersive Stream for XRと連携｜BUSINESS NETWORK	<サービス開始>,<提携>	<製品サービス>
Twitter、今月中にDMにエンド・ツー・エンド暗号化を導入か	<方針>,<利用・採用>,<コラム>	<技術コラム>
開催前のポイント解説！アイデアをビジネスプランに育てる「新規事業アイデア創出」とは？ | Biz/Zine	<生活>,<コラム>,<技術開発>	<技術コラム>
株式会社WAVE3は、SAKURA UNITED PLATFORMと提携の元、GameFiを活用した障害者就労継続支援サポートをスタートしました	<障害>,<支援>,<コラム>	<経済>
インドネシアでISO/IEC 27001の認証を取得	<政府・認可>	<政治>
AWSアカウントとKubernetesを悪用してデータ窃取する「SCARLETEEL」攻撃に注意	<コラム>	<tab不明-オピニオン>
＜ぱらぱらじっくり　教育に新聞を＞ワードクラウドを活用　児童の文章レベル上げる：東京新聞 TOKYO Web	<技術開発>,<利用・採用>,<方針>,<コラム>	<技術コラム>
6P Color「Full Color Range」システム、SXSW Innovation Awardのファイナリストに選出	<表彰>	<社会>
ビジネスメタバースのoVice、ポストコロナ時代の成長加速に向け、Amplitudeを採用	<目標>,<利用・採用>	<技術トピック>
【第2回】物流DX（デジタル・トランスフォーメーション）を成功に導くヒント～会社の成長に必要不可欠なDX人材を育成するためのポイント～	<コラム>	<tab不明-オピニオン>
クラウドサーカス、ソフトバンク営業網活用でデジマSaaSの導入拡大へ	<方針>,<利用・採用>,<目標>	<技術トピック>
Mac（Macbook Air/Macbook Pro）Time Machineの使用方法と消えたデータの復元方法についてご紹介｜Tenorshare 4DDiG（Mac）V5.1.3をリリース	<紹介>,<サービス開始>	<製品サービス>
キャリアアップを目指すなら「やらないことリスト」作成を（Forbes JAPAN）	<方針>,<目標>,<コラム>	<tab不明-オピニオン>
寺田倉庫 CM制作を業務効率化する新機能「Terra sight SPLIT」を提供開始	<サービス開始>,<技術提供>	<製品サービス>
【ランドセルは同調圧力の温床か？】立正大学教授・社会学博士 小宮信夫氏による提起「小学生はランドセルで通学すべきか？」Surfvoteで投票開始。	<コラム>	<tab不明-オピニオン>
ミリ波を用いたダークマター探索手法を確立 | TSUKUBA JOURNAL - テクノロジー・材料	<技術開発>	<技術トピック>
スマホの次なる必須機能は「DIY修理」		
リモートワークでも創造的にゼロからイチを生み出せる。スマートなメタバースアプリ「Teracy(テラシー)」がβ版テスターの募集を開始。	<募集>	
なぜTaskUsのAIサービスが自動運転トップ企業に選ばれるのか？	<表彰>,<コラム>	<社会>
VMware、5Gの能力を生かせるソリューションを通信事業者（CSP）に提供	<技術提供>,<サービス開始>	<製品サービス>
福島とウクライナの生徒の声: 放射能と戦争の中で共に生きる（3月10日（金）17:30-19:30 オンライン開催）ワークショップの参加者受付中	<意見>,<イベント>	<イベント>
Digital Platformer、新プロダクト「SHIKI」を用いた実証実験を鹿児島市と開始	<実験>	<技術トピック>
MITTRが選んだ 世界を変える10大技術 2023年版	<コラム>,<技術開発>	<技術コラム>
PocketRD提供のi avatarとDigital Doubleの基幹エンジンが採用されたKDDI株式会社のαU metaverse、αU dotadp、αU marketがサービスを開始しました	<利用・採用>,<コラム>,<サービス開始>	<製品サービス>
Blackmagic Design導入事例：フランス・ バレーボールリーグ中継放送の場合	<説明>	<tab不明-トピック>
フォアスカウトが現代のSecOpsの課題に取り組むべくForescout XDRの提供を開始：時事ドットコム	<社会情勢>,<コラム>,<社会問題>,<サービス開始>,<技術提供>	<製品サービス>
Upscaled Multiplayer、All-new KONA が航続距離の延長と進化した機能でヒョンデの電動化ビジョンを加速	<方針>,<技術開発>	<技術トピック>
stu がKDDIの新メタバース・Web3サービス「αU」とデジタルツインで再現した都市空間でリアルとバーチャルを融合させた新しいライブコンテンツを共創		
超広帯域とマルチアンテナによってすべての帯域で5G化が加速し、高品質オールシナリオ・モバイルネットワークに向かう：時事ドットコム	<技術開発>,<コラム>	<技術コラム>
クラウド事業にデスク共有を導入予定のGoogleのオフィスは“ゴーストタウン”		
LCA GAME GUILDとDMMグループ会社のDM2C Studioが戦略的パートナーシップを締結	<契約>,<受注>	<製品サービス>
「開発の民主化」を掲げ、日本での展開を本格化--コヒーレントのブリスコCEO	<技術開発>,<海外展開>	<経済>
車載用モータードライバーＩＣの無料ウェブセミナーを今月開催＝東芝デバイス〔ＢＷ〕：時事ドットコム	<セミナー>,<技術開発>	<イベント>
Ayar Labs、業界初4-Tbps光ソリューションをデモ | e.x.press	<実験>	<技術トピック>
ルネサスがインドのハイテク2都市に開発拠点、Tata Consultancyと協業	<提携>	<経済>
オールインワン3Dインテリアデザインツールを展開するManycore(郡核)とは？ | 建設テックメディア CONTECH MAG	<業界情報>,<方針>,<コラム>	<経済>
株式会社 エルザ ジャパン様、新規Matterport販売リセラー契約締結のお知らせ	<契約>,<業績>,<商品化>	<製品サービス>
超広帯域とマルチアンテナによってすべての帯域で5G化が加速し、高品質オールシナリオ・モバイルネットワークに向かう：時事ドットコム	<技術開発>,<コラム>	<技術コラム>
クラウドサーカス、ソフトバンク営業網活用でデジマSaaSの導入拡大へ	<方針>,<利用・採用>,<目標>	<技術トピック>
フォアスカウトが現代のSecOpsの課題に取り組むべくForescout XDRの提供を開始：時事ドットコム	<社会情勢>,<コラム>,<社会問題>,<サービス開始>,<技術提供>	<製品サービス>
スマホの次なる必須機能は「DIY修理」		
ビジネス動画編集クラウド「Video BRAIN」（ビデオブレイン）ChatGPTを搭載した対話型の動画制作アシスト機能を公開	<イベント>	<イベント>
「electronica 2022」展示会レポート	<イベント>,<レポート>	<イベント>
インドネシアでISO/IEC 27001の認証を取得	<政府・認可>	<政治>
アイスリーデザイン「新産業革命到来！？ChatGPT APIのビジネス活用法相談セミナー」を開催	<セミナー>	<イベント>
MAPXUSとNOIZが世界初の屋内ロケーションベースのGAMEFIメタバース構築へ	<設備投資>,<目標>	<経済>
ビジネスメタバースのoVice、ポストコロナ時代の成長加速に向け、Amplitudeを採用	<目標>,<利用・採用>	<技術トピック>
株式会社WAVE3は、SAKURA UNITED PLATFORMと提携の元、GameFiを活用した障害者就労継続支援サポートをスタートしました	<障害>,<支援>,<コラム>	<経済>
Mapbox for EVにより、自動車メーカーが消費者向け電気自動車ソリューションを提供可能に	<技術開発>	<技術トピック>
VMware、5Gの能力を生かせるソリューションを通信事業者（CSP）に提供	<技術提供>,<サービス開始>	<製品サービス>
SAKURA UNITED PLATFORMは、株式会社WAVE3と提携し、スカラーシップ制度を活用した障がい者就労支援を開始します	<提携>,<支援>,<コラム>	<経済>
マイクロソフト、チャットＧＰＴ統合を拡大　開発ツールにも追加	<技術開発>,<サービス開始>	<製品サービス>
「ThreaX／Azure RTOS」の悔恨から生まれた「PX5 RTOS」はできたてほやほや	<コラム>	<tab不明-オピニオン>
株式会社アシスト（代表取締役：宇井和朗）AI搭載CMSをリリース	<サービス開始>	<製品サービス>
cTraderのChart StreamをSpotwareが実現：自分のテクニカル分析を毎日24時間配信可能：時事ドットコム	<技術開発>	<技術トピック>
rfアイデアズ、IDmelon搭載のエンドツーエンドFIDO2認証情報ソリューションをリリース：時事ドットコム	<サービス開始>	<製品サービス>
令和４年度 Hamamatsu ORI-Project／浜松市データ連携基盤活用サービス実装支援補助金の合同成果発表会をオンラインで開催します！	<イベント>,<コラム>	<イベント>
Mouseflowが、2023年「世界のTOP50プロダクト」に選出！	<表彰>	<社会>
アイ・グリッド・ソリューションズ　いすゞ初の量産BEV「ELF EV」への施設と連動した充電マネジメントの機能連携を開始	<提携>	<経済>
Xilinx由来のアクセラレーターと第4世代EPYCの電力効率を武器に、vRAN市場への浸透を目指すAMD	<方針>,<目標>,<時制.未来>	<tab不明-トピック>
カメラベースのハンドトラッキング対応触覚グローブ、法人向けに発売	<商品化>	<製品サービス>
Apple Watch Ultraをケーブルなしで高速充電。Apple MFi認証の信頼性、史上最速水準、超小型の「Maco Go 2」開発プロジェクトの支援者をクラウドファンディングで募集開始。	<支援>,<募集>	<経済>
【神奈川県 BAK 共創事例】Hamee × Koeerü、ECと卸売両面から「顧客の声を可視化する」小売事業者向けプラットフォームの実証を開始！	<説明>,<実験>	<技術トピック>
ECと卸売両面から「顧客の声を可視化する」小売事業者向けプラットフォームの実証実験を開始	<実験>	<技術トピック>
ECと卸売両面から「顧客の声を可視化する」 小売事業者向けプラットフォームの実証実験を開始	<技術開発>,<実験>	<技術トピック>
【業界初】医療情報特化型AI『Medical DOC AI(TM)』の第一弾サービスとして「Medical DOC AI(TM)チャットボット」の共同開発を開始	<技術開発>	<技術トピック>
ホンダ、自動走行の電動台車を開発　高性能センサー活用 - 日本経済新聞	<技術開発>,<利用・採用>,<市場動向>	<経済>
AWS、通信キャリア向けマネージドサービスを発表　NECとNTTドコモのArm CPU活用の低消費電力コア実証実験を展示	<商品化>,<イベント>	<製品サービス>
BlocPower、低所得者向け建物の脱炭素化を拡大するために200億円超を調達	<社会統計>,<資金>	<経済>
6P Color「Full Color Range」システム、SXSW Innovation Awardのファイナリストに選出	<表彰>	<社会>
協振技建の建築設備ＣＡＤシリーズとは | サポーターズ・コーナー	<コラム>	<tab不明-オピニオン>
データを活用できずにいる企業の多さが浮き彫りに--セールスフォース調査	<社会問題>,<調査>	<社会>
岐阜信用金庫が「e-dash」を活用した中小企業向けサステナビリティ・リンク・ローンのフレームワークを構築	<設備投資>	<経済>
危険なショッピングサイトを即確認「SAGICHECK」が日本語サイトに対応 ～ JC3 情報提供（ScanNetSecurity）	<技術開発>,<調査>,<技術提供>,<サービス開始>	<製品サービス>
日本初(※1)のスマートホームカオスマップも発表！スマートホームの現在地がわかるカンファレンス「LIVING TECH week 2022-2023」3月16日(木)から4日間、開催決定！	<レポート>,<イベント>	<イベント>
グループのAI研究をさらに推進すべく、サイジニアアドバンスド研究所を設立	<設立>	<経済>
ファーウェイ、MWC 2023に巨大ブースを出展！『HUAWEI WATCH Buds』が8つのメディアアワードを受賞し、スマートウェアラブルにおけるイノベーションが話題に	<イベント>,<表彰>,<コラム>	<イベント>
いすゞ自動車／商用BEVで、カーボンニュートラルソリューション	<技術開発>	<技術トピック>
パブリック・ブロックチェーン「Japan Open Chain」、マルチチェーンNFT生成プラットフォーム「NFT Garden」との接続に関する覚書を締結	<契約>,<受注>	<製品サービス>
Blackmagic Design導入事例：フランス・ バレーボールリーグ中継放送の場合	<説明>	<tab不明-トピック>
環境配慮認証管理サービスを提供するGreen Badger | 建設テックメディア CONTECH MAG	<技術提供>,<サービス開始>	<製品サービス>
温暖化対策で注目のCO2回収テクノロジー｢DAC｣　世界最大規模のプラントが続々と稼働するワケ	<設備投資>,<サービス開始>,<コラム>	<製品サービス>
ユーグレナ、バイオ燃料を都内で試験販売開始　内燃機関車の救世主となるか｜自動車部品・素材・サプライヤー｜紙面記事	<サービス開始>,<コラム>	<製品サービス>
学校で習わない本当の自然のしくみ、無しとされる「摩擦」のエネルギ―について｜自然のしくみ｜iloha colour｜note		
なるかホンダ、SUV「ZR-V」で起死回生　雪上試乗で感じた勝算（日経クロストレンド）	<コラム>,<意見>	<tab不明-オピニオン>
なぜ意外な場所で「軽自動車」が走っている？ 謎ナンバー装着「N-BOXカスタム」が話題に… 海外の日本車事情とは（くるまのニュース）	<コラム>	<tab不明-オピニオン>
稼働中メガソーラーをFITからFIPへ変更【JRE】PPA締結の子会社に電力を販売	<譲渡・買収>,<商品化>	<製品サービス>
HEVに続き、PHEVも登場。トヨタ「5代目プリウス」の実力に迫る！（週プレNEWS）	<業界情報>,<商品化>,<コラム>	<製品サービス>
日本電産のイーアクスル　重希土類は｢脱中国｣、年内ゼロ - 日経モビリティ		
ＯＲＣ発電、低温排熱でも高効率／馬渕工業所、東大生産研など５キロワット級開発 | 電気新聞ウェブサイト	<技術開発>,<生産活動>	<製品サービス>
非接触・非侵襲型検査で急成長を続けている未来価値創造企業の新たな取り組みとは？	<紹介>,<コラム>	<tab不明-オピニオン>
YouTuberから自動車メーカーへ　1人乗り「超小型EV」開発　維持費は軽自動車10分の1【広島発】（FNNプライムオンライン）	<目標>,<技術開発>,<設備投資>	<経済>
エネルギー消費、改修で６割減…大成建設が「省エネビル」公開	<社会統計>,<設備投資>	<経済>
「Z」の究極の乗り味を実現するテストドライバーたち	<技術開発>,<実験>	<技術トピック>
スバルの「水平対向エンジン」は永遠に不滅？ 新社長が言及!? “スバルらしさ”今後どうなる？（くるまのニュース）	<コラム>	<tab不明-オピニオン>
産総研など、n型MoS2トランジスタで低コンタクト抵抗を実現	<技術開発>	<技術トピック>
英新車登録、２月は26％増加　前月から伸び加速＝ＳＭＭＴ 英国・自動車・二輪車	<特許>,<商品化>,<社会統計>,<現象>	<製品サービス>
ダウ、Ｘｅ―１００施設開発　Ｘ―エナジーとＪＤＡ締結	<技術開発>,<契約>,<受注>	<製品サービス>
ダウ　先進小型モジュール原子炉、米国工業地に配備へ – 日刊ケミカルニュース	<目標>	<tab不明-トピック>
ホンダ「シビック」、ガソリン車とHVも受注停止　慢性的な半導体不足で　受注再開時期は未定｜自動車メーカー｜net＋	<障害>,<サービス終了>,<社会問題>	<製品サービス>
《【特集】スマートエネルギーWeek春》2023年ブースピックアップ③：ラプラス・システム	<コラム>	<tab不明-オピニオン>
バクテリアを含むインクによる3Dプリンティングで骨のような合成物 | e.x.press	<技術開発>	<技術トピック>
ホンダ、「シビック」の受注停止　車載半導体不足で - 日本経済新聞	<サービス終了>,<社会問題>,<市場動向>	<製品サービス>
岩谷産業が陸上養殖事業拡大/研究所に閉鎖循環設備導入	<方針>,<利用・採用>,<サービス終了>	<製品サービス>
機構報 第1602号：出資型新事業創出支援プログラム（ＳＵＣＣＥＳＳ）におけるアルファフュージョン株式会社への出資決定について	<コラム>	<tab不明-オピニオン>
【持続可能性とエネルギー効率】ハイデルベルグ、印刷会社向け省エネキャンペーンを開始	<技術開発>,<イベント>	<イベント>
半導体冷却への効果的なアプローチ		
純エンジンのV12搭載車はホントにこれが最後！　ランボルギーニのラストを飾る２台のワンオフモデル!!		
「アヴェンタドール」後継モデルのエンジンが明らかに！ ランボルギーニ史上最もパワフルな12気筒は出力合計「1015馬力」に！（Auto Messe Web）	<コラム>	<tab不明-オピニオン>
米ＧＭ傘下クルーズ、今年はコスト削減に重点＝ＣＯＯ		
東京大学など、スピンホール効果の大きいタングステン発見 - 日経テックフォーサイト	<技術開発>,<研究>	<技術トピック>
東北・上越火力がギネス認定 世界最高効率も脱炭素の暗雲	<政府・認可>,<表彰>,<市場動向>	<政治>
【3月第1週資金調達まとめ】アストロスケールが101億円を調達 | Forbes JAPAN 公式サイト（フォーブス ジャパン）	<コラム>,<資金>	<経済>
MLCCサプライヤ各社が自動車向け製品に注力、TrendForce調べ	<業界情報>,<調査>	<経済>
JOGMECが米アラスカ州でメタンハイドレートの全坑井の掘削作業完了　長期陸上産出試験へ　各種センサーケーブル設置 | 電波新聞デジタル	<実験>,<目標>,<組織>,<設備投資>	<経済>
豪日産、今後18カ月で新たに４車種販売へ - NNA ASIA・オーストラリア・車両	<商品化>,<目標>	<製品サービス>
ミリ波を用いたダークマター探索手法を確立	<技術開発>	<技術トピック>
“MTアリ”のホンダ新型「シティ」発表に賛否！ アンダー200万円の“コンパクトセダン”国内需要アリ？ 印導入の”イケ顔セダン”日本導入はあるのか（くるまのニュース）	<コラム>	<tab不明-オピニオン>
体力“見える化”へ世界初の新技術　ファンケルが実用化向け検証　医療やスポーツ、幅広い分野での応用期待 - 記事詳細｜Infoseekニュース	<技術開発>,<研究>,<調査>	<技術レポート>
ホンダの小型ハイブリッドセダン『シティ』に改良新型、燃費は27.1km/リットル…インド発表（レスポンス）		
ホンダ、自動走行の電動台車を開発　高性能センサー活用 - 日本経済新聞	<技術開発>,<利用・採用>,<市場動向>	<経済>
リンナイ　ハイブリッド給湯・暖房システム　エコワン　30年に年間30万台販売 | 電波新聞デジタル	<商品化>	<製品サービス>
〈ウォールストリートジャーナルの記事から〉自動車メーカー悩ます難題：EV普及のスピード｜企画・解説・オピニオン｜紙面記事		
【ライブ配信セミナー】廃プラスチック高度リサイクルのための光学識別技術　4月10日（月）開催　主催：(株)シーエムシー・リサーチ	<セミナー>,<技術開発>	<イベント>
アルファフュージョンが4.5億円を資金調達、 Atの安定供給は2025年めど	<資金>,<目標>	<経済>
野村総研、50年度温暖化ガス排出ゼロ　スコープ3も対象 - 日経GX		
ＪＯＧＭＥＣ、炭素中立で国営石油と協力 - NNA ASIA・マレーシア・資源	<提携>	<経済>
都立大学、廃プラを化成品に変える新触媒　資源循環期待 - 日経テックフォーサイト	<コラム>,<見解>,<要望>	<tab不明-オピニオン>
メルシャン・藤沢工場にPPAモデル太陽光発電を導入 年間124トンのGHG排出量を削減	<利用・採用>,<技術開発>	<技術トピック>
光るグリルが斬新!? ホンダが革命的な「新型SUV」初公開！ もはや懐かしい「HR-V」が劇的進化し中国市場に投入へ（くるまのニュース）	<コラム>,<イベント>,<商品化>,<技術動向>,<技術開発>,<利用・採用>	<製品サービス>
市川リサイクルセンター 　一般廃棄物処理施設竣工のお知らせ | 住友大阪セメント	<技術開発>	<技術トピック>
【大豆ミートの最前線】カゴメ「プラントベース」シリーズ好調、各種メニュー提案も | 食品産業新聞社ニュースWEB	<市場動向>,<提案>,<生活>	<経済>
ネクストミーツ、コストコ全店で大豆ミート展開 - 日本食糧新聞電子版	<業界情報>,<方針>	<経済>
弘前大学・京都大学との共同研究で、健康ビックデータから『女性のメンタル不調』に『鉄分不足』が関係していることを確認	<技術開発>,<調査>,<研究>	<技術レポート>
心斎橋パルコ、22年度売上高が約30％増　高感度ファッションやキャラクター雑貨がけん引 | 繊研新聞	<技術開発>,<業績>,<市場データ>,<背景>	<経済>
ビール技術生かし完成 「麒麟百年 極み檸檬サワー」 高単価RTD拡大目指す キリンビール - 食品新聞 WEB版（食品新聞社）	<方針>,<目標>,<コラム>,<生活>	<tab不明-オピニオン>
ポッカサッポロフード＆ビバレッジ（株）と協働開発「サッポロ ニッポンのシン・レモンサワー」新発売	<商品化>	<製品サービス>
サワイグループHD・木村生産統括役員　生産キャパ確保に注力　製品在庫「現在４か月超あたりをキープ」 | ニュース | ミクスOnline	<生産活動>,<業界情報>	<製品サービス>
ダウンメーカーNANGAの23年2月期　旗艦店も寄与し30％増収へ　海外も順調に拡大 | 繊研新聞	<業績>,<目標>,<海外展開>	<経済>
ケンコーマヨネーズ、第3四半期はファストフード向け商品採用などで増収 - 日本食糧新聞電子版	<業績>	<経済>
パン・パシフィック・インターナショナルHD×ミスターマックスHD 家計応援ディスカウンターを比較（日刊ゲンダイDIGITAL）		
特別企画　ホームセンターバイヤーが選ぶ年間ヒット商品2023！ _小売・物流業界 ニュースサイト【ダイヤモンド・チェーンストアオンライン】	<設備投資>	<経済>
ミンティア　クリームソーダ｜ミンティア レギュラー｜タブレット｜菓子｜商品情報｜アサヒグループ食品	<生活>	
【セミナー】広告と通販、印刷メディアの最新動向 | JAGAT	<セミナー>	<イベント>
給食に出て話題になったコオロギなどの「昆虫食」--安全性や価格、生産ガイドラインは？	<コラム>,<価格>,<生産活動>,<設備投資>	<製品サービス>
大正製薬、弘前大・京大との共同研究で健康ビックデータから「女性のメンタル不調」に「鉄分不足」が関係していることを確認 - 日本経済新聞	<技術開発>,<調査>,<研究>,<市場動向>	<経済>
賛否両論の「糖尿病治療薬で痩せるサービス」が136億円で買収される（Forbes JAPAN）	<譲渡・買収>	<経済>
JAL、生理や更年期の苦しみ軽減する「フェムテック実証プログラム」。男性社員ともに相互理解を深め“働きやすさ”追求へ（Impress Watch）	<技術開発>	<技術トピック>
運動で糖尿病を改善　ウォーキングは1日15分でも効果がある　運動でメンタルヘルスも守れる｜ニュース｜糖尿病ネットワーク	<技術開発>,<コラム>	<技術コラム>
バングラデシュの余剰在庫を日本でアップサイクル　「スマセル」など3社共同で | 繊研新聞		
半導体黎明期から製造装置開発に取り組んできたリーディングカンパニーTOWAの技術力に迫る！	<コラム>	<tab不明-オピニオン>
【テルモ】佐藤 慎次郎社長CEOの 「3本柱で世界と戦っていく」		
D2C企業の戦略から読むインド市場（2）パーソナルケア | 地域・分析レポート - 海外ビジネス情報	<コラム>,<市場動向>,<レポート>	<経済>
日清紡＆ネスレ日本がタッグ、廃棄紙パックから「衣服」生産　社団法人「アップサイクル」設立（WWDJAPAN.com）	<生産活動>,<設立>	<製品サービス>
売場・販促ビッグデータ「店舗DB」を活用した訪日外国人観光客向け店舗の売場構築支援サービス開始	<設立>,<設備投資>	<経済>
プラントベースフードブランド「2foods」の公式オンラインショップにて「エバーチキンナゲット 定期便」3月8日 スタート	<サービス開始>	<製品サービス>
中3娘の母「ガリガリにやせているのにもっとやせたいと言って食べない」　拒食の相談の大半は母親から〈dot.〉（AERA dot.）	<生活>,<コラム>,<障害>	<社会>
腎臓病でも野菜や果物を全く食べないのはＮＧ　新潟大学大学院・若杉三奈子特任准教授らの研究グループが報告（夕刊フジ）	<生活>,<障害>,<情報公開>	<経済>
菊正宗酒造、「糖質ゼロ」リニューアル - 日本食糧新聞電子版	<サービス更新>	<製品サービス>
物流施設需要に製造業の在庫積み増し影響、CBRE	<市場動向>,<コラム>	<経済>
日立GLSら4社、台湾地域での再生医療の発展を目的とする協業に向け基本合意書を締結 | Biz/Zine	<目標>,<契約>,<受注>	<製品サービス>
摂食障害　医師の態度に疑問の声	<障害>,<社会問題>,<意見>	<社会>
部活や勉強後にリフレッシュ&塩分チャージ！ 『マッチ 塩レモンソーダ 500mlペットボトル』『マッチゼリー マスカット 260gペットボトル』		
明治、防災備蓄のLaspyに出資　ミルクやゼリー提供 - 日本経済新聞	<政府・補助金>,<支援>,<投資>,<技術提供>,<サービス開始>,<市場動向>	<製品サービス>
三起商行　海外売上高が6割に　今期、海外店舗数100店超え | 繊研新聞	<業績>,<社会統計>	<経済>
「医療IT」企業は株価と業績の踊り場を脱却できるか？エムスリー、メドピア、ケアネット…	<コラム>	<tab不明-オピニオン>
シンギ、食品の凍結機など販売拡大　ロス削減需要捉える - 日本経済新聞	<市場動向>,<コラム>	<経済>
広島市のシンギ、急速凍結機の販売拡大 - 日本経済新聞	<市場動向>	<経済>
《トップに聞く》ナイスコーポレーション社長　井筒伊久磨氏　Bコープ認証取得目指す | 繊研新聞	<対談>,<コラム>,<方針>,<目標>	<その他>
｢スーパー｣｢食品｣利益確保へ向けた悪戦苦闘	<目標>	<tab不明-トピック>
酒造タイスピリット、市場シェア15％目標 - NNA ASIA・タイ・食品	<目標>,<生活>	<tab不明-トピック>
#国際女性デー　低用量ピル費用補助の会社が増加　ドン・キホーテ運営会社は全額負担（テレビ朝日系（ANN））	<社会統計>,<政府・補助金>,<現象>	<政治>
木徳神糧、新中計で体制再構築　事業規模と領域拡大 - 日本食糧新聞電子版	<設備投資>	<経済>
尾家産業中日本東部地区　第3四半期売上げ、26％増着地　京都の好調要因 - 日本食糧新聞電子版	<市場データ>,<業績>	<経済>
2023 年３月８日各      位会 社 名 株式会社トレジャー･ファクトリー代表者名 代表取締役	<業界情報>,<レポート>,<イベント>	<経済>
フジッコ、大豆ヨーグルトをリニューアル　カスピ海乳酸菌使用 - 日本食糧新聞電子版	<サービス更新>	<製品サービス>
要望に沿ったオリジナルリキュールを30Lから委託製造【K.S.P】		
一部商品を390円(税別)に値下げしました。	<価格変更>,<コラム>	<製品サービス>
5類移行、感染防止「五つの基本」示す　厚労省アドバイザリーボード | 毎日新聞	<社会問題>,<障害>,<社会事件>,<レポート>,<コラム>,<方針>	<社会>
日本産甘藷のプロモーション、スイーツをターゲットにベルギーで実施(ベルギー) | ビジネス短信 ―ジェトロの海外ニュース	<イベント>,<レポート>	<イベント>
株式会社ＯＰＡ×有限会社やまぎん「サステナブルプロジェクト」始動！～インフォメーション制服をサステナブル素材に～	<方針>,<技術開発>	<技術トピック>
Metaのこれから｡ARにVR、ウェアラブルもやるみたい	<コラム>	<tab不明-オピニオン>
定番の時間管理術に失敗する人が知らない真実、ToDoリスト・カレンダー…（ダイヤモンド・オンライン）	<設備投資>	<経済>
世界最大級のデータ分析プラットフォームKaggleにおいてKaggle Master二階堂の参加するチームが金メダルを獲得	<コラム>	<tab不明-オピニオン>
構成イメージから自社に適したパッケージが一目でわかる！ユニアデックスオリジナルAVSパッケージ	<コラム>	<tab不明-オピニオン>
RATIONALの調理システムiCombi Proが全機種でENERGY STAR(R)認証を取得【ラショナル・ジャパン】｜外食業界の新店舗、新業態など、最新情報｜ニュース｜フーズチャネル	<政府・認可>	<政治>
FRONT-END.AI、Figma 連携を強化。高精度でhtml出力するプラグインをユーザー向けに提供開始	<技術開発>,<提携>,<サービス開始>,<技術提供>	<製品サービス>
クロスキャット、DX推進サポートサービス「groWiz」提供開始	<商品化>	<製品サービス>
サービス終了の「Echo VR」復活なるか？ VRゲームファンたちが抗議広告を“シリコンバレーの青空”に展開	<サービス更新>,<コラム>,<業界情報>,<方針>	<製品サービス>
米国FDA／迅速承認のラベリングを厳しくしなさいよ！ | GMP Platform	<コラム>	<tab不明-オピニオン>
データブリックス、レイクハウス向けリアルタイム機械学習の新機能を提供	<技術提供>,<サービス開始>	<製品サービス>
SB C&S　GIGAスクール		
基幹システムのクラウド移行をAzure VMware Solutionで実現	<技術開発>	<技術トピック>
EARTHBRAINとCTC、「横浜港新本牧ふ頭整備事業」に3Dモデルを用いた情報共有クラウドを提供	<技術提供>,<サービス開始>,<情報提供>	<製品サービス>
AIが狙われている--インターネットに潜む次なる脅威	<コラム>,<社会事件>,<社会問題>	<社会>
mRNA メーカーさん、お使いになっている「GMPグレード」の原材料、大丈夫ですか？ | GMP Platform	<技術開発>,<コラム>	<技術コラム>
Google Cloud Platformからデータ漏洩しても検出できない、専門家が指摘	<コラム>,<意見>	<tab不明-オピニオン>
映像遅延0.5秒を誇るTMF Earthが法人向けの「arrows BZ 02」を導入した理由とは？	<方針>,<利用・採用>,<コラム>	<技術コラム>
レーザーフィッシュがミュールソフトとの新たな統合を発表：時事ドットコム	<技術開発>	<技術トピック>
クリエイターのためのノートパソコン「GIGABYTE AERO 2023」が登場、充実の機能でクリエイティビティを引き出す	<商品化>,<コラム>	<製品サービス>
「プライバシー サンドボックス」に新UI ～「Google Chrome 111」が正式版に（Impress Watch）		
量子誤り訂正に成功したグーグル、次に挑む量子コンピューター実用化の最難関とは	<コラム>	<tab不明-オピニオン>
ユビキタスAI、ZETANE Systems社と販売代理店契約を締結、AIのロバスト性向上支援ツール「ZETANE Protector」「ZETANE Insight Engine」を3月8日提供開始	<契約>,<受注>,<サービス開始>,<技術提供>	<製品サービス>
Windows 11はハードウェア・OS・クラウドの三位一体で実現するセキュアなOS - 日本マイクロソフト勉強会から	<技術開発>,<イベント>	<イベント>
EC-CUBE の制作実績 No1 株式会社 Refine | EC-CUBE 向け Amplitudeプラグインを開発、無料展開へ	<技術開発>,<目標>,<業界情報>,<方針>	<経済>
3/28ウェビナー開催　アバターは「昭和型の社会」を変えるか？	<セミナー>,<コラム>	<イベント>
tokyo.ex #22 (2023/03/19 13:00〜)		
異なる携帯ネットワークに対応した共通API構想「GSMA Open Gateway」が始動　提供されるAPIの内容は？：開発者やクラウドプロバイダーの迅速なサービス強化、展開を支援	<方針>,<コラム>,<サービス開始>,<支援>	<製品サービス>
ヤプリ 、アパレルEC向けサイズレコメンドエンジン「unisize」と連携開始〜 アプリ上のECサイトに「unisize」を簡単に導入可能へ 〜	<提携>,<コラム>,<技術開発>,<目標>	<経済>
Azure Vmware Solution（AVS）をユニアデックスが超かんたんに解説！	<説明>	<tab不明-トピック>
野村総合研究所、「ブランドランキング2023」を発表開始 | ニュースリリース | 野村総合研究所(NRI)	<技術開発>,<レポート>	<技術レポート>
INTEGRAL-COREとSynergy!が連携・キーコーヒー株式会社に導入開始〜CDPで複数チャネルのデータを統合、顧客コミュニケーションの最適化へ	<提携>,<方針>,<利用・採用>,<技術開発>,<目標>	<経済>
FOM出版ブランドの新刊「よくわかるWord 2021ドリル」を発売	<商品化>	<製品サービス>
塩野義製薬がコミュニケーション基盤をZoomに変更　「医師らの間で馴染みある」　ZVC JAPANが発表 | ニュース | ミクスOnline	<コラム>	<tab不明-オピニオン>
Plug and PlayのSaeed CEO、「日本のスタートアップは		
TPM2.0に脆弱性　影響は数十億台か |  財経新聞	<障害>,<コラム>	<社会>
WOVNが主催する日本最大級のインバウンドカンファレンス『GLOBALIZED インバウンド2.0』に当社代表の丸山智義が登壇しました	<セミナー>,<コラム>	<イベント>
【来週開催】booost technologies、「第2回 脱炭素経営EXPO [春]」にて海外拠点を含むサプライチェーン全体のCO2等排出量可視化について展示	<イベント>	<イベント>
テキストファイルなどをPostScriptファイルに変換する「GNU a2ps」v4.15		
SONOSから次世代スマートスピーカー「Era 300」「Era100」が3月29日に全世界で発売。Era 300はドルビーアトモスに対応し、空間オーディオによるサウンド体験も実現（Stereo Sound ONLINE）	<商品化>,<技術開発>	<製品サービス>
夫婦間にお金の共通認識を。そして誰もがお金に困らない社会へ。 OsidOri x HAKUHODO Fintex Base（連載：フィンテックが変える生活者体験 Vol.12） ｜博報堂WEBマガジン センタードット	<目標>,<コラム>,<レポート>	<tab不明-オピニオン>
Appleは全身スキャンでもっとユーザーの健康管理がしたいらしい	<コラム>	<tab不明-オピニオン>
AIAG & VDA FMEAに対応した新エディションを提供開始	<サービス開始>,<技術提供>	<製品サービス>
【時事英語】“Arms race” ってどういう意味？ | ニュースの「キーワード」で語彙力を身につける	<コラム>	<tab不明-オピニオン>
藤野和志さん（情報学専攻博士前期２年）が国際ワークショップNCSP'23においてStudent Paper Awardを受賞│電気通信大学		
米国FDA／コンサルタント: GMP 欠陥に対する普遍的な救済策か? | GMP Platform	<コラム>	<tab不明-オピニオン>
法人向けサービス「CAICA Web3 For Biz」の提供を開始！Web3ビジネス創出のためのマッチングを展開	<サービス開始>,<技術提供>,<業界情報>,<方針>	<製品サービス>
Synergy!がCDPのINTEGRAL-COREと連携、キーコーヒー株式会社に導入開始	<提携>,<方針>,<利用・採用>	<経済>
ARソリューション開発のTaqtile、半導体大手クアルコムと協業。AR開発プラットフォームの活用へ	<提携>,<技術開発>,<目標>	<経済>
MQDC Idylliasが、世界で初めて現実と仮想を完全につなぎ、全ての人に持続可能性をもたらす「生きるもの全てが見えるMetta－Verse」としてスタート	<サービス開始>,<コラム>	<製品サービス>
株式の電子トレーディング担当者に需要、米銀など採用計画－調査	<戦略>,<調査>	<tab不明-トピック>
エルビット・システムズ社が、DSEI Japan 2023でプラットフォームを展示	<イベント>	<イベント>
データブリックス、レイクハウス向けリアルタイム機械学習の新機能を提供	<技術提供>,<サービス開始>	<製品サービス>
セールスフォースがChatGPT対応　マーケ業務も生成AIが必須に	<技術開発>	<技術トピック>
RATIONALの調理システムiCombi Proが全機種でENERGY STAR(R)認証を取得【ラショナル・ジャパン】｜外食業界の新店舗、新業態など、最新情報｜ニュース｜フーズチャネル	<政府・認可>	<政治>
Metaのこれから｡ARにVR、ウェアラブルもやるみたい	<コラム>	<tab不明-オピニオン>
レーザーフィッシュがミュールソフトとの新たな統合を発表：時事ドットコム	<技術開発>	<技術トピック>
コンガテックとコントロン、COM-HPC評価用キャリアボードを共同で標準化することで合意	<契約>	<経済>
ロボットサービスの商用化に乗り出すSKT、AIパトロールロボットの披露 | 亜洲日報	<技術開発>	<技術トピック>
異なる携帯ネットワークに対応した共通API構想「GSMA Open Gateway」が始動　提供されるAPIの内容は？：開発者やクラウドプロバイダーの迅速なサービス強化、展開を支援	<方針>,<コラム>,<サービス開始>,<支援>	<製品サービス>
米新興Plus One Robotics、6.8億円を資金調達	<資金>	<経済>
いすゞ自動車／トータルソリューションプログラム「EVision」を開始	<サービス開始>,<技術開発>	<製品サービス>
ブラジルのデジタル銀行がChatGPTを週4日勤務制度の味方に	<コラム>	<tab不明-オピニオン>
SB C&S　GIGAスクール		
日本交通とMoT、専用乗務員「GO Crew」によるアプリ専用車「GO Reserve」--受注を限定		
モジュール式製造システムを極めたワンケーブル・ソリューション	<技術開発>	<技術トピック>
EARTHBRAINとCTC、「横浜港新本牧ふ頭整備事業」に3Dモデルを用いた情報共有クラウドを提供	<技術提供>,<サービス開始>,<情報提供>	<製品サービス>
【日本】KDDI、三菱重工、NECネッツエスアイ、サーバー冷却消費電力の94%削減に成功。液浸冷却 | Sustainable Japan | 世界のサステナビリティ・ESG投資・SDGs	<レポート>,<技術開発>,<コラム>,<投資>,<社会問題>	<経済>
未来志向の工作機械に向けたボールねじ送り系の状態安定化機構 『 NSK Feed Drive Adjuster™ 』 | Webマガジン「NSK Stories」| 企業情報	<目標>,<技術開発>	<技術トピック>
三菱商事の“M-Lab”が米スタートアップとの新たな関係作りへ--“バーチャルジョイントベンチャー”に進化	<目標>,<コラム>,<技術動向>	<技術コラム>
仏ACC、欧州のギガファクトリー生産能力増強で仏SEGULAを選定	<表彰>	<社会>
扶桑電通／倉庫運用管理システム「LogiPull WES」紹介セミナー	<セミナー>	<イベント>
構成イメージから自社に適したパッケージが一目でわかる！ユニアデックスオリジナルAVSパッケージ	<コラム>	<tab不明-オピニオン>
世界最大級のデータ分析プラットフォームKaggleにおいてKaggle Master二階堂の参加するチームが金メダルを獲得	<コラム>	<tab不明-オピニオン>
クロスキャット、DX推進サポートサービス「groWiz」提供開始	<商品化>	<製品サービス>
『 Metareal AI 』 発表。ChatGPT等を５千社超の顧客基盤から活用推進　生成系AIをはじめとした膨大なAI製品群を統一プラットフォームでワンストップ提供を目指す	<技術開発>,<利用・採用>,<方針>,<技術提供>,<サービス開始>,<コラム>,<時制.未来>	<製品サービス>
Plug and PlayのSaeed CEO、「日本のスタートアップは		
「Global Industrie 2023」に出展　産業機器におけるリチウムイオン二次電池「EnerCera」、高温ガス集塵装置「セラレックシステム」を紹介 | ニュース | 日本ガイシ株式会社	<イベント>,<紹介>	<イベント>
基幹システムのクラウド移行をAzure VMware Solutionで実現	<技術開発>	<技術トピック>
Pendo、2022年度の決算を発表、エンタープライズの顧客数の伸び率が過去最高を記録	<業績>,<市場データ>	<経済>
AmeliaがBuildGroupとMonroe Capitalからの1億7500万ドルの投資を発表	<投資>	<経済>
Apple、ドイツ半導体拠点に10億ユーロ　設計機能強化 - 日経テックフォーサイト	<技術開発>,<方針>	<技術トピック>
KEIYO新商品　車載用ディスプレイオーディオで動画配信サービスを快適に楽しめるマルチデバイス機器【APP CAST】発売！	<商品化>,<コラム>,<技術開発>	<製品サービス>
株式の電子トレーディング担当者に需要、米銀など採用計画－調査	<戦略>,<調査>	<tab不明-トピック>
【来週開催】booost technologies、「第2回 脱炭素経営EXPO [春]」にて海外拠点を含むサプライチェーン全体のCO2等排出量可視化について展示	<イベント>	<イベント>
B2Bマーケティングを体系的に“学び続ける場”「Symphony Marketing Intelligent Growth Club」のメンバーシップ募集	<募集>	
本社課題であった働き方改善のために、アイウェアブランド「OWNDAYS」が電話自動応答サービス「IVRy」を導入しリモートワークを推進	<方針>,<利用・採用>	<技術トピック>
そのPC、メモリ増設して大丈夫？DDR5メモリの「ある仕様」にPCパーツメーカーが警鐘鳴らす - トピックス｜Infoseekニュース	<コラム>	<tab不明-オピニオン>
サービス終了の「Echo VR」復活なるか？ VRゲームファンたちが抗議広告を“シリコンバレーの青空”に展開	<サービス更新>,<コラム>,<業界情報>,<方針>	<製品サービス>
StreamlitやLeapYearなど積極的買収のSnowflake、その狙いを本国幹部に訊ねる	<コラム>	<tab不明-オピニオン>
「プライバシー サンドボックス」に新UI ～「Google Chrome 111」が正式版に（Impress Watch）		
インフィニオンテクノロジーズ、最小の3Dカメラシステムを実現するi-ToFイメージャーを発表 - 日本経済新聞	<技術開発>,<市場動向>	<経済>
日本初(※1)のスマートホームカオスマップも発表！スマートホームの現在地がわかるカンファレンス「LIVING TECH week 2022-2023」3月16日(木)から4日間、開催決定！：時事ドットコム	<レポート>,<イベント>	<イベント>
オカムラ「ORV」 カゴ車の搬送 省力化 AIと自律移動技術搭載 | 輸送経済新聞社	<技術開発>,<市場動向>,<生産活動>	<製品サービス>
ファーウェイ、MWC 2023に巨大ブースを出展！『HUAWEI WATCH Buds』が8つのメディアアワードを受賞し、スマートウェアラブルにおけるイノベーションが話題に	<イベント>,<表彰>,<コラム>	<イベント>
小田急線車内サイネージ「小田急TV(OTV)」 時間帯区分に応じた広告配信及びパッケージ販売の実証実験を開始	<実験>,<営業活動>	<製品サービス>
PTCジャパン、製造業向けALMソフトウエアに注力　自動車などソフト開発で採用実績PTCジャパン | 電波新聞デジタル	<業界情報>	<経済>
サイジニアがグループの研究開発体制を一段と強化する「サイジニアアドバンスド研究所」設立（モーニングスター）	<技術開発>,<方針>,<組織>,<研究>,<設立>	<経済>
クリテオ、リテールメディア向け広告配信基盤のBrandcrushを買収	<譲渡・買収>	<経済>
日産がバーチャル店舗の実証実験、若い世代をつかむタッチポイントに	<実験>	<技術トピック>
AIが狙われている--インターネットに潜む次なる脅威	<コラム>,<社会事件>,<社会問題>	<社会>
タクシー業界「EV」に熱視線、普及の壁高いのになぜ？ 「パワー不足」という世間の妄言を糺す | Merkmal（メルクマール）	<コラム>	<tab不明-オピニオン>
欧州の全面EVシフトに「待った」、EUの政策に注文つけるドイツメーカーの本音（JBpress）		
「生産CO2フリー製品」プロジェクトについて、第三者機関による妥当性評価を取得	<政府・認可>	<政治>
アーサー・ディ・リトル、最新の「Autonomous Mobility Journal」で自動運転車の市場動向を予測	<予測>,<市場動向>	<経済>
世界の産銅大手、2050年までに温室効果ガス実質ゼロ化計画	<コラム>,<戦略>	<tab不明-オピニオン>
電動二輪の関税免除を、シンクタンク - NNA ASIA・フィリピン・車両		
日産、中国で自動運転タクシーの勝算　レッドオーシャンで勝てるか	<コラム>	<tab不明-オピニオン>
まさか2024年モデルが投入されるとは……R35 GT-Rの中古車相場がダダ下がり!　で今が買い時？（ベストカーWeb）	<利用・採用>,<コラム>	<技術コラム>
LPG船にバイオ燃料、日本郵船が試験航海 ニュースイッチ by 日刊工業新聞社	<実験>	<技術トピック>
タイプRにつづき　ホンダ・シビック/シビックe:HEV受注停止に　半導体不足　生産見通せず（AUTOCAR JAPAN）(ヘッドライン) | 自動車情報サイト【新車・中古車】 - carview!	<障害>,<サービス終了>,<社会問題>,<生産活動>,<コラム>	<製品サービス>
５時間速習！プラスチックの基礎講座と成形不良対策	<対策>	<経済>
SLBが坑井建設用セメントの代替低炭素技術を発表：時事ドットコム	<技術開発>,<設備投資>	<経済>
「暗黒物質ダークマター」は《お母さん》？「だからぜひ会ってみたいですね」と言い切る理論物理学者・村山斉さんが語る「人類すべての母」（サイエンスZERO） @gendai_biz	<コラム>	<tab不明-オピニオン>
京大など、軽量ダークマター候補「ダークフォトン」検出向けの技術を開発	<技術開発>	<技術トピック>
二酸化炭素の放出や環境破壊の原因に、データセンターは今どう変わるべきか？	<コラム>	<tab不明-オピニオン>
スプーン/フォークの違いで、食事が美味しく感じる！？　　　　　　　　　　　　　　　　『スプーン/フォークの使い心地の良さが、最大6.0倍も違うことを初めて脳波測定...	<意見>,<コラム>,<技術開発>	<技術コラム>
高伝導率の配線をデバイス上に容易に描画できる技術の開発に成功<br>～従来よりも簡便かつ低コストで作製が可能、貼り付け型センサなどへの応用に期待～｜東京理科大学	<技術開発>	<技術トピック>
近未来テクノロジー見聞録(323) NTTと静岡大学が超伝導磁束量子ビットを用いて神経細胞中の鉄イオンを検出	<技術開発>	<技術トピック>
〔2023年3月8日リリース〕接着能が失われた細胞の接着因子を呼び起こす〜新たな三次元培養技術として期待〜 | 2022年度 プレスリリース一覧 | プレスリリース | 広報・社会連携 | 大学案内 | 国立大学法人 東京農工大学	<サービス開始>,<コラム>,<技術開発>,<見解>,<要望>,<提携>	<製品サービス>
京大ら，ミリ波でダークフォトンの探索手法を確立 | OPTRONICS ONLINE　オプトロニクスオンライン	<技術開発>,<設備投資>	<経済>
ランボルギーニの真骨頂！　"3000万円オーバー"のウラカンを公道試乗!!（週プレNEWS）		
積水化学が「空飛ぶクルマ」スタートアップに出資した狙い ニュースイッチ by 日刊工業新聞社	<政府・補助金>,<支援>,<投資>,<コラム>	<政治>
〈新車リポート〉マツダ「CX-90」　米国のニーズを考えた3列シートSUV｜自動車メーカー｜紙面記事	<見解>	<tab不明-オピニオン>
実験モジュール「夢天」、燃焼実験キャビネットが初の点火実験に成功 | Science Portal China	<実験>	<技術トピック>
「中国EVに乗り換えようかな」日本車の牙城は今　タイの現状（西日本新聞）	<コラム>	<tab不明-オピニオン>
タマデン工業、「太陽光×ディーゼル自家発」で安定電力　ハイブリッドシステム開発	<コラム>,<技術開発>	<技術コラム>
ロケット失敗も次があるぜ!　日本のものづくりはまだまだ!!　日本が誇るナンバーワンメーカーがすごい（ベストカーWeb）	<コラム>	<tab不明-オピニオン>
【提言】大量生産社会は「森を溶かす」ことで終わりを告げる	<コラム>	<tab不明-オピニオン>
ハイエース並の長いボディ！　でも車高はハチロク並にぺったんこ！　なんじゃこりゃが詰まったアストンマーティンの超絶セダン「ラゴンダ」って何もの？ | goo - 自動車	<コラム>	<tab不明-オピニオン>
スバル『フォレスター』新型は2024年登場!? 水平対向エンジンにトヨタHV搭載で大幅燃費アップか？（レスポンス）(ヘッドライン) | 自動車情報サイト【新車・中古車】 - carview!	<商品化>,<コラム>	<製品サービス>
呉市は「2050年ゼロカーボンシティ」を宣言しました - 呉市ホームページ	<方針>,<コラム>	<tab不明-オピニオン>
大ガス、FIP太陽光買い取り　年5000kW超、長期契約	<契約>,<受注>	<製品サービス>
非可食油原料樹の植林を起点としたSAFサプライチェーン構築について	<コラム>	<tab不明-オピニオン>
相次ぐロケット打ち上げ失敗／トヨタ佐藤新社長は会見でどう答えたか／ラピダスが目指す2nm世代のGAAって何？	<コラム>	<tab不明-オピニオン>
双日などが日本初の重希土類レアアース権益獲得　脱中国依存へ - 日本経済新聞	<コラム>,<目標>,<市場動向>	<経済>
アーバンエナジーの太陽光ＰＰＡモデル導入　日本化薬が福山工場に	<方針>,<利用・採用>	<技術トピック>
積水化学工業、eVTOLなど開発する独Volocopterと資本業務提携　日本での事業拡大を支援 | Biz/Zine	<提携>,<支援>	<経済>
土の生物性診断１点3,000円、1週間以内に結果をお届け、価格を1/10に、スピードを1/3以下に大幅な技術革新、当社で実施した最新の技術情報等を「作物生産と土づくり」に...		
スカイライン「クロスオーバー」復活か!?　BEVになって2025年登場!!（ベストカーWeb）	<サービス開始>,<サービス更新>,<コラム>,<商品化>	<製品サービス>
クリプト錬金術師が見た幻：SZ MEMBERSHIPで最も読まれた5記事（2023年2月）	<見解>,<コラム>	<tab不明-オピニオン>
納期遅延のいま先代を狙うのも大いにアリ！　３代目ハリアーの魅力に迫る	<コラム>	<tab不明-オピニオン>
［東日本大震災１２年］処理水放出、大きな一歩へ／春から夏頃開始目標 | 電気新聞ウェブサイト	<目標>	<tab不明-トピック>
植物の雌雄の決定に定説を覆す新しい仕組みが関与する可能性、岡山大など (1)	<コラム>	<tab不明-オピニオン>
なぜ新しいメルセデスAMG SL43は2.0リッターとは思えぬ走りなのか？ 贅沢すぎる最新オープンカーを徹底解説！（GQ JAPAN）	<コラム>	<tab不明-オピニオン>
HOYAがRE100加盟、日本企業78社目		
第44回 ディスプレイ産業フォーラム(2) スマホの需要回復を牽引するFlexible AMOLED、車載市場に向かうLTPS		
ホンダ、自律移動実験用車両「Honda AWV」3代目プロトタイプ公開	<イベント>	<イベント>
暖房機のコロナ、石油給湯器をモデルチェンジ - 日本経済新聞	<市場動向>	<経済>
【テルモ】佐藤 慎次郎社長CEOの 「3本柱で世界と戦っていく」		
理科大，レーザーでフィルム上に多層CNTを直接作製 | OPTRONICS ONLINE　オプトロニクスオンライン	<技術開発>,<設備投資>	<経済>
バスクリン、入浴と風邪・インフルエンザ罹患の関連性に新知見｜週刊粧業オンライン	<設備投資>	<経済>
ＳＭ過半数が４月以降「賃上げ」/業界団体調査　中小は検討中多く	<市場データ>,<調査>	<経済>
〈体験ルポ〉減塩食が美味しくなる？ キリンが開発中の“塩味が1.5倍になる”お椀＆スプーン『エレキソルト』の実力を検証してみた（集英社オンライン）	<研究>,<調査>	<技術レポート>
デジタルを活用した脳の健康の見える化により持病者の健康意識や認知機能テストスコアが向上	<技術開発>	<技術トピック>
慢性腎臓病は適度な運動で生命予後が延び、生活の質が上がる【健康長寿のカギは腎臓にあり】（日刊ゲンダイDIGITAL）	<コラム>	<tab不明-オピニオン>
21年度化粧品通販売上高、市場規模は8%増　上位85社総計5933億円、市場成長率が復調の兆し	<商品化>,<市場データ>,<技術開発>,<業績>,<投資>	<製品サービス>
「受療行動調査」にみる生活習慣病の自覚症状の有無	<見解>	<tab不明-オピニオン>
病気予防を目指すなら、ウォーキングは1日何歩がいい？	<コラム>	<tab不明-オピニオン>
抗がん剤「エンハーツ」が拡大期へ  【第一三共】新社長に奥澤宏幸CFO	<目標>	<tab不明-トピック>
毎日11分の早歩きが病気になるリスクを減らすという研究結果	<技術開発>,<コラム>	<技術コラム>
働く女性の多くが“体の悩み” 異なる業種14社で健康調査実施（ABEMA TIMES）	<方針>	<tab不明-トピック>
歩行や家事など、軽い活動をしている時間が多い高齢者ほど認知機能が高いと判明	<コラム>,<技術開発>	<技術コラム>
バクスター、慢性腎臓病患者の治療啓発のためのグローバルキャンペーンを開始	<イベント>	<イベント>
粧業日報2023年3月8日（第15876号）｜週刊粧業オンライン	<設備投資>	<経済>
ベネクス／新経営体制へ移行／プレミアアンチエイジング傘下に（2023年3月9日号） | EC | 日本ネット経済新聞 | 日流ウェブ	<市場動向>	<経済>
未来予想図の構築と共有で成功を目指す、ヤマハ発動機の新規事業開発（JBpress）	<設備投資>,<コラム>,<時制.未来>,<技術開発>	<経済>
エア・ウォーターが３社での協業を発表 ベジテック、デリカフーズと	<提携>	<経済>
明治、市販用アイスクリームやチョコレートなどを5月29日から順次値上げ - 日本経済新聞	<価格変更>,<市場動向>	<製品サービス>
「ネスカフェ ゴールドブレンド」で簡便性求めつつも本格的な味わいも求めるニーズに対応　こだわりの「オリジン」シリーズ刷新（食品新聞）	<技術開発>,<サービス更新>	<製品サービス>
生鮮食品を売らないと意味がない！？ プロが教える「儲かるネットスーパー」のポイント _小売・物流業界 ニュースサイト【ダイヤモンド・チェーンストアオンライン】	<コラム>,<設備投資>	<経済>
「プロジェクト・ビジョン2022」展示発表会イベントレポート クーパービジョン・ジャパン×東工大野原研究室産学連携プロジェクト	<イベント>,<レポート>	<イベント>
(株)JTBと(株)スマートヘルスネット（(株)ＴＢグループ100％子会社）と基本契約締結に関するお知らせ	<契約>	<経済>
１００歳超の人、ゲノムも元気…本来の年齢より１０歳以上若く保たれている傾向（読売新聞オンライン）		
摂食障害の子どもの患者が高止まり…保護者や養護教諭が気づけるサインとは？　#こどもをまもる（withnews）	<コラム>	<tab不明-オピニオン>
～早期発見、継続治療で緑内障による失明を減らそう～「ライトアップinグリーン運動」を展開 | プレスリリース | 愛媛大学	<技術開発>,<コラム>,<業界情報>,<方針>	<経済>
もちっとロカボ麺＜ゆず塩ラーメン＞（日清食品チルド）2023年3月1日発売 - 日本食糧新聞電子版	<商品化>	<製品サービス>
「娘の“花粉症”が糖質制限食で改善された」現役医師に届いた読者からの嬉しい報告	<技術開発>,<コラム>,<情報公開>	<経済>
エスエスケイフーズ、6月1日納品分から家庭用・業務用のマヨネーズ類・ソース類を値上げ | THE OWNER	<価格変更>	<製品サービス>
米国小売に学ぶ、顧客との強固な繋がりの重要性 | AdverTimes.（アドタイ） by 宣伝会議	<コラム>,<会議>	<政治>
医療へのAI活用は市民に受け入れられるか？ ～有効な新技術の普及に向けて～（時事通信）	<コラム>,<目標>,<技術開発>	<技術コラム>
新薬3種で治療、大きく進展 　「2歳で生命の危険」の難病SMA（朝日新聞デジタル）	<イベント>	<イベント>
Waqoo、第1四半期の売上39.4％減の4億8900万円 参入増で顧客獲得に苦戦	<市場データ>,<業績>	<経済>
「物価高で生活に打撃」91％で昨年5月比16ポイント増 --- 防衛策は光熱費削減がトップ、物価高上回る賃上げ期待できず76％ ---	<社会情勢>,<社会統計>,<見解>,<要望>,<市場データ>	<経済>
【変化する菓子通販商戦】「高級」「推し」が台頭／「自分へのご褒美品」開発に注力も（2023年3月9日号） | EC | 日本ネット経済新聞 | 日流ウェブ	<業界情報>,<市場動向>	<経済>
尿路感染症疑い高齢者への抗菌薬、医師への適正使用支援で6割減／BMJ		
みずほリサーチ&テクノロジーズ ： 認知症の人の就労継続実現に向けて	<コラム>,<目標>	<tab不明-オピニオン>
【特集・糖尿病】教えてドクター・食事、運動で血糖値改善／お薬相談室・余分な糖を尿と排出【元気＋らいふ】 | 上毛新聞社のニュースサイト	<コラム>	<tab不明-オピニオン>
ビナミルク、牛肉加工で合弁工場 - 日本経済新聞	<市場動向>	<経済>
サントリー・23年RTD事業　若年・食中・ノンアルに注力 - 日本食糧新聞電子版	<経済>,<業界情報>	<経済>
勃興インド農薬　工場投資続々、普及遅れの巨大市場に的（写真=ロイター） - 日本経済新聞	<技術開発>,<市場動向>	<経済>
横河電機の「地球の未来」にフォーカスしたパーパスは、こうして生まれた（JBpress）	<社会情勢>	<社会>
認知症リスクを高める「難聴」　“耳鳴り”には要注意？セルフチェックで早期発見を【大分】（TOSテレビ大分）	<方針>,<技術開発>,<研究>	<技術トピック>
グローバル展開拡大に向けた採用強化を図る製薬大手・協和キリン キャリア採用では手厚いオンボーディングフォローを実施	<利用・採用>	<技術トピック>
美味しさも栄養もさらに妥協なし！コストコで購入できる「低糖質パン」を試してみた｜Mart（magacol）	<利用・採用>,<コラム>	<技術コラム>
新感覚ドリンク。朝専用あまざけ「AM」のオンラインストアがオープン	<サービス開始>	<製品サービス>
一正蒲鉾・中間決算　コスト増、営業益60％減　新工場で競争力強化 - 日本食糧新聞電子版	<業績>,<市場データ>,<技術開発>,<方針>	<経済>
5類移行、感染防止「五つの基本」示す　厚労省アドバイザリーボード（毎日新聞）	<方針>,<コラム>,<社会問題>,<障害>,<社会事件>,<レポート>	<社会>
サントリー、伊ワイナリーとサステナビリティーで協定 - 日本経済新聞	<契約>,<市場動向>	<経済>
次の一手は韓国企業の買収、高収益事業で「弾」を増やすオリンパス	<技術開発>,<設備投資>	<経済>
アルファフュージョン、シリーズAをファーストクローズし、アスタチン創薬を加速～臨床入り薬剤に加え、がん領域の複数パイプライン創出で世界をリード～	<資金>,<技術開発>	<経済>
今週の注目5社：AIプレゼン資料作成 / スマート手術針 / 仮想通貨送金プラットフォーム / カスタマーサクセスプラットフォーム / トレカ価値算定アプリ	<提携>,<技術開発>	<経済>
Windows Insider Program、Canaryチャネル追加 |  財経新聞	<サービス開始>	<製品サービス>
InMobi、iOS上のプログラマティック広告を強化：InMobi DSPをSKAdNetwork4.0に対応、iOS向け新入札機能の提供を開始	<営業活動>,<技術開発>,<サービス開始>,<技術提供>	<製品サービス>
DoubleVerify、Google Campaign Manager 360でトラフィックのワークフロー全体を効率化する「DV Campaign Automator™」の提供を開始	<サービス開始>,<技術提供>	<製品サービス>
個人も無料で始められる! ソニー新サービス「Creators’ Cloud」ってなに?（Impress Watch）	<コラム>	<tab不明-オピニオン>
新しい静的コード解析ツール「Ruff」をご紹介	<紹介>	<tab不明-トピック>
[Amazon期間限定プロモーション]新しくアップグレードされた Android 12 タブレットがたったの 14,900 円になりました。急いで手に入れましょう！	<コラム>,<価格>	<製品サービス>
【ニュートピ！ゆるいニュース (4406P) 】 Windows 11の要件でもあるTPM 2.0に脆弱性。数十億台に影響 - PC Watch	<障害>,<コラム>	<社会>
Angular 16のSignalプリミティブ型：わくわくするべき理由	<コラム>	<tab不明-オピニオン>
CoeFontのAI音声を、「紡ネン」などのAIを活用したVTuberを運営するPictoriaが会話用音声として採用	<利用・採用>	<技術トピック>
MAPXUSとNOIZが世界初の屋内ロケーションベースのGAMEFIメタバース構築へ	<設備投資>,<目標>	<経済>
Canary版「Windows 11」が初公開 ～Build 25314の配信が開始／WinUI 3版「エクスプローラー」の改善やセキュリティ強化など	<イベント>,<営業活動>,<技術開発>,<方針>	<製品サービス>
「ホグワーツ・レガシー」、新たなパッチを配信開始！多数のバグ修正を実施（Impress Watch）	<営業活動>	<製品サービス>
アビッド、Media Composer最新バージョンリリース。Pro Toolsとの連携を強化	<提携>	<経済>
カルダノベースのJPGストアがノーコードNFTツールの早期アクセスを開始	<技術開発>	<技術トピック>
AWSでアクセスキーが漏洩した際に検知・削除する仕組みを実装する	<技術開発>,<コラム>	<技術コラム>
リーガルテックグループJAPANMADE事務局社、シニア向け動画チャンネル「HusimeTV」新動画、『団塊の世代のスマホ挑戦　「ARお天気シミュレーター編」デジタルって人生より難しいもんか 笑』	<コラム>	<tab不明-オピニオン>
「AIソフトウェアの標準規格が必要」 専門家らが語る	<コラム>	<tab不明-オピニオン>
【新ノーコードスクール誕生】実践的なノーコード開発スキルを学びセカンドキャリアを切り開くためのオンラインスクール「Tech Studio」が募集を開始。	<サービス開始>,<設備投資>,<募集>	<製品サービス>
【投資・ビジネスの必須知識】AI、IoT、ドローンで使われる半導体とは？	<技術開発>,<コラム>	<技術コラム>
macOS版Outlookアプリが無料化。Microsoft 365がなくても利用可能に（Impress Watch）	<技術開発>	<技術トピック>
マイクロソフト、「Outlook for Mac」を無料提供！ 購入もサブスクもなしで使えます（GetNavi web）	<技術提供>,<サービス開始>,<技術開発>,<コラム>	<製品サービス>
Amazonの広告ビジネスは5兆円規模でAmazonプライムやAWSの収益を超えているという指摘、その急成長の仕組みとはどのようなものか？	<業界情報>,<社会統計>,<市場データ>,<意見>	<経済>
人の脳活動をスキャンして見ているものを画像化するAIを開発！	<技術開発>	<技術トピック>
ソーシャルPLUS、「andar JAPAN」にLINE連携のShopifyアプリを導入 購入率が約20％向上	<利用・採用>,<社会統計>	<技術トピック>
「Google グループ」はGoogleから放置されており、ただ死にゆくのみであるという指摘	<コラム>,<意見>	<tab不明-オピニオン>
STEAM教育の真骨頂！国際ロボット競技大会を日本で開催「VEX IQ Competition Japan Cup in 2023」	<イベント>	<イベント>
JAL、全客室乗務員が利用するiPad端末にDittoの通信技術を導入へ	<方針>,<利用・採用>,<目標>	<技術トピック>
【速報】コインベースが、Wallet as a Service（WaaS）を発表		
ブライトコーブがメディア向け「広告マネタイズ」サービス開始 | Media Innovation	<サービス開始>	<製品サービス>
SentinelOne と Wiz が、エンド ツー エンドのクラウド セキュリティを提供するための独占的パートナーシップを発表		
Mac用ブラウザ「Arc」が優秀すぎた。今すぐ試すべき5つの理由（ライフハッカー・ジャパン）	<コラム>	<tab不明-オピニオン>
最安値23,900円！BMAX「I11 Plus」Android12 128GB タブレットキャンペーン実施中！	<イベント>	<イベント>
ソフトバンク、「DIGNO BX2」をAndroid 12に更新するOSアップデート	<サービス更新>,<技術開発>	<製品サービス>
テスラの次世代EV戦略発表、「OnePlus」初のタブレット--週間人気記事をナナメ読み（3月2日～3月8日）	<コラム>	<tab不明-オピニオン>
脳が知覚した内容を「Stable Diffusion」が画像化　脳活動を解析　阪大などが技術開発（ITmedia NEWS）	<技術開発>	<技術トピック>
iPhon15 Proシリーズ用LiDARスキャナをソニーが供給で何が改善される？	<技術開発>,<コラム>	<技術コラム>
テキサス州オースティンで開催される「SXSW Creative Industries Expo 2023」に出展	<イベント>	<イベント>
Primate、Apple M2/M2 Proチップを搭載した「MacBook Pro (2023)」のGeekbench 6スコアの掲載を開始。Macでは新しい機械学習ワークロードによりIntel Macのランキングが下がる。	<サービス開始>,<技術開発>,<コラム>	<製品サービス>
ICP DAS - BMP、韓国ソウルで「KIMES 2023」の来場者に高機能医療用TPUペレットをアピール	<コラム>	<tab不明-オピニオン>
「Windows 11 22H2」で巨大ファイルのSMBコピーが遅くなる問題、ようやく解決（Impress Watch）	<コラム>,<社会問題>	<社会>
ついにPlayStation 5でDiscord音声通話が可能になったので設定手順をまとめてみた	<コラム>	<tab不明-オピニオン>
日本語字幕起こしに対応したWindows 11 Insider新ビルド（Impress Watch）	<技術開発>	<技術トピック>
中国のWeChatがデジタル人民元を統合して支払いを強化	<技術開発>,<方針>	<技術トピック>
ZTEが動的に調整可能なRISと小型軽量のプライベート5Gコア製品をMWCで公開	<イベント>,<技術開発>,<商品化>	<製品サービス>
日産、自動車の選定から購入契約まで済ませられるメタバース店舗「NISSAN HYPE LAB」		
ルネサス、Arm Heliumテクノロジを搭載したCortex-M85プロセッサによるAI実装デモをembedded worldで展示 | Renesas	<イベント>	<イベント>
InnodiskがEmbedded World 2023でAIoTソリューションを展示	<イベント>	<イベント>
Carlsberg Groupが英国、フィンランド、フランスの各ブランドで環境再生型農業による大麦の使用拡大を計画	<戦略>	<tab不明-トピック>
マレーシアMDA／カスタムメイド医療機器の届出に関するガイダンスを発表 | GMP Platform		
日産自動車ら、メタバース空間上で車両販売・試乗などが行える仮想店舗の実証実験を開始 | Biz/Zine	<実験>	<技術トピック>
EVメーカーフォロフライ モービルアイ社製前方事故防止用 ADASで物流ドライバーの安全をサポート	<技術開発>,<支援>	<経済>
GMの次世代ADAS、運転シナリオの95％でハンズフリー走行を可能に	<技術開発>	<技術トピック>
InMobi、iOS上のプログラマティック広告を強化：InMobi DSPをSKAdNetwork4.0に対応、iOS向け新入札機能の提供を開始	<営業活動>,<技術開発>,<サービス開始>,<技術提供>	<製品サービス>
テスラの次世代EV戦略発表、「OnePlus」初のタブレット--週間人気記事をナナメ読み（3月2日～3月8日）	<コラム>	<tab不明-オピニオン>
テキサス州オースティンで開催される「SXSW Creative Industries Expo 2023」に出展	<イベント>	<イベント>
香港初となる「Gravio」販売代理店契約を締結し販路を拡大！IoT製品開発ライブセンス（豪）香港支社と販売パートナー契約を締結	<契約>,<受注>,<方針>	<製品サービス>
Axelera AIとアドバンテックが協力し、データセンターの推論能力をエッジデバイスにもたらす：時事ドットコム	<提携>,<コラム>,<技術開発>	<経済>
個人も無料で始められる! ソニー新サービス「Creators’ Cloud」ってなに?（Impress Watch）	<コラム>	<tab不明-オピニオン>
【アメリカで大好評の機能も追加！】ゴルフ用パーソナル弾道測定分析機器「Mobile Launch Monitor (MLM)」グローバルアプリ リリース	<サービス開始>,<技術開発>	<製品サービス>
VOLLMONT(フォルモント)ホールディングス、AIロボット2種(車両片側交互通行誘導ロボットと歩行者誘導ロボットを「SECURITY SHOW 2023」にて実機出展！	<イベント>	<イベント>
日産、自動車の選定から購入契約まで済ませられるメタバース店舗「NISSAN HYPE LAB」		
カワダロボティクス「NEXTAGE」のサードパーティオプションに新ラインナップが登場！ハンド・周辺機器に加えて、AIなどのソフトウェアのパートナー募集も強化中！	<商品化>	<製品サービス>
楽天も利用の仏物流スタートアップ「Cubyn」、約20億円を調達　無人倉庫導入で効率向上（36Kr Japan）	<資金>,<技術開発>	<経済>
ChatGPTの波紋広がる。Appleが「AI開発」を見直していると台湾紙が報道	<業界情報>,<コラム>,<サービス更新>	<製品サービス>
日産がUnreal Engineでリアルな新車ショールーム、営業スタッフも常駐：VRニュース		
OPPO、MWC 2023にて2050年までにカーボンニュートラルの達成を宣言	<方針>	<tab不明-トピック>
ブライトコーブがメディア向け「広告マネタイズ」サービス開始 | Media Innovation	<サービス開始>	<製品サービス>
INFiLED WPシリーズ導入、超高精細な超大型スクリーンでプレゼン鮮明に	<方針>,<利用・採用>	<技術トピック>
Energous、e-peasと空間伝送型ワイヤレス電力伝送システムの普及に向けた協業を開始 | ニュース | 日本ガイシ株式会社	<提携>	<経済>
【NTT Com】社会課題解決に向け、事業共創プログラム「OPEN HUB for Smart World」の機能を拡張、"共創"は新たなステージへ	<技術開発>,<芸能>,<目標>	<技術トピック>
【韓国】現代モービス、車高自動調整システムを開発（NNA）	<技術開発>	<技術トピック>
Infineon、UMCと車載向け40nmプロセスeNVMマイコン生産で長期契約を締結	<契約>,<受注>	<製品サービス>
MAPXUSとNOIZが世界初の屋内ロケーションベースのGAMEFIメタバース構築へ	<設備投資>,<目標>	<経済>
ACES 話者が複数人存在するオンライン商談の自動要約技術に関する特許を取得	<特許>,<政府・認可>	<政治>
アナログ・デバイセズ、Envision Energyがスマート風力タービンにMEMSセンサー技術を採用 - 日本経済新聞	<利用・採用>,<市場動向>	<経済>
サービスロボットとChatGPT連動に成功、世界に向けて β テストを開始　OrionStar Robotics	<技術開発>,,<目標>,<実験>	<技術トピック>
KEIYO新商品　車載用ディスプレイオーディオで動画配信サービスを快適に楽しめるマルチデバイス機器【APP CAST】発売！	<商品化>,<コラム>,<技術開発>	<製品サービス>
メタバースが一気に民主化、自律的なアバターをいとも簡単に生み出す新技術	<コラム>,<技術開発>	<技術コラム>
ノーコードで誰でも作成可能なメタバースの作成サービスの提供開始	<サービス開始>,<技術提供>	<製品サービス>
SCREEN、次世代パターン用直接描画装置「LeVina(レビーナ)」の2μm対応モデルを開発し販売開始 - 日本経済新聞	<技術開発>,<サービス開始>,<市場動向>	<製品サービス>
「AIソフトウェアの標準規格が必要」 専門家らが語る	<コラム>	<tab不明-オピニオン>
EVメーカーはそろそろ充電設備のことを真剣に考え始めるべきだろう	<コラム>	<tab不明-オピニオン>
「りんな」提供元、ChatGPTの技術を製品開発に活用へ　「Azure OpenAI Service」導入（ITmedia NEWS）	<技術提供>,<サービス開始>,<目標>,<技術開発>,<方針>,<利用・採用>	<製品サービス>
ウーバー、物流部門の売却か分社化を検討＝ＢＢＧ	<組織変更>,<譲渡・買収>	<経済>
トリナ・ソーラー・ジャパン株式会社が[第16回国際太陽光発電展PV EXPO2023]に出展新型モジュールフルラインアップを初お披露目！	<イベント>,<商品化>	<製品サービス>
今週の注目5社：AIプレゼン資料作成 / スマート手術針 / 仮想通貨送金プラットフォーム / カスタマーサクセスプラットフォーム / トレカ価値算定アプリ	<提携>,<技術開発>	<経済>
HollylandがSolidcom C1 Proを発表－業界初の無線デュアルマイクENCインターカムヘッドセットシステム		
図面データを「活用」することで価値を生み出す「CADDi DRAWER」　―CADDi 白井氏インタビュー	<コラム>	<tab不明-オピニオン>
HPC市場規模、2030年に873億1000万ドル | e.x.press	<市場データ>	<経済>
いすゞ、初のEV小型トラックを発売　商用車でも電動化加速（朝日新聞デジタル）	<商品化>,<方針>	<製品サービス>
『 Metareal AI 』 発表。ChatGPT等を５千社超の顧客基盤から活用推進　生成系AIをはじめとした膨大なAI製品群を統一プラットフォームでワンストップ提供を目指す	<技術開発>,<利用・採用>,<方針>,<技術提供>,<サービス開始>,<コラム>,<時制.未来>	<製品サービス>
DoubleVerify、Google Campaign Manager 360でトラフィックのワークフロー全体を効率化する「DV Campaign Automator™」の提供を開始	<サービス開始>,<技術提供>	<製品サービス>
クエクテルがEU28カ国向けにプリペイドの定額制IoT接続パッケージを発表 – とれまがニュース		
JAL、全客室乗務員が利用するiPad端末にDittoの通信技術を導入へ	<方針>,<利用・採用>,<目標>	<技術トピック>
ZTEが動的に調整可能なRISと小型軽量のプライベート5Gコア製品をMWCで公開	<イベント>,<技術開発>,<商品化>	<製品サービス>
トランスコスモスとモビルス、オリエントコーポレーションのチャットサポートに「Secure Path」を導入し、運用を提供	<方針>,<利用・採用>,<技術提供>,<サービス開始>	<製品サービス>
フォロフライEVに前方事故防止システム｜短報		
itelが通信事業者との緊密な協力により、アフリカでコスト効率に優れたスマートフォンのA60を投入：時事ドットコム	<利用・採用>	<技術トピック>
リーガルテックグループJAPANMADE事務局社、シニア向け動画チャンネル「HusimeTV」新動画、『団塊の世代のスマホ挑戦　「ARお天気シミュレーター編」デジタルって人生より難しいもんか 笑』	<コラム>	<tab不明-オピニオン>
蓄電池やＥＶ、２６年度から需給調整市場に／家庭のエネルギー源、参画へ案 | 電気新聞ウェブサイト		
「性能はシリコン半導体の10倍以上⁉」青色LEDノーベル物理学受賞者が進める「窒化ガリウム・半導体革命」《電力損失大幅低減》《大容量無線通信》（現代ビジネス）	<コラム>	<tab不明-オピニオン>
本当？ 日産が電動車の価格を「エンジン車」並に！ 新型e-POWER初公開！ 2026年には車両コスト低減へ（くるまのニュース）	<コラム>,<イベント>	<イベント>
東南アジアの経済成長、天然ガス調達が左右＝調査（ロイター）	<調査>	<tab不明-レポート>
日産の新しい電動パワートレーン「X-in-1」って何だ!?　2026年までに発売（ドライバーWeb）	<コラム>,<商品化>	<製品サービス>
太陽光発電優先のハイブリッド給湯機　1次エネルギー消費量を約45%削減 » 建材・設備のデータベース「スマテリアル」	<技術開発>	<技術トピック>
マイカーの「完全自動運転」、やっぱり実現不可能？ 大雨・降雪・障害物など課題山積、米スタートアップもお手上げか | Merkmal（メルクマール）	<コラム>,<障害>	<社会>
そのうちガソリン車レベルに? 日産の電動車コストダウン作戦が進展（マイナビニュース）	<コラム>,<イベント>	<イベント>
新型ランクルプラドはディーゼルハイブリッド!?　モデル末期でもバカ売れプラドの新型どうなる？（ベストカーWeb）	<コラム>	<tab不明-オピニオン>
AGC ガラス製造で脱CO2実証実験へ　燃料をアンモニアに代えて（FNNプライムオンライン（フジテレビ系））	<実験>,<目標>	<技術トピック>
「パワー半導体では青色LEDの時よりももっと社会貢献したい」ノーベル物理学賞受賞者・天野浩が何よりも「人のため」にこだわるそのワケ（サイエンスZERO） @gendai_biz	<技術開発>,<コラム>,<紹介>	<技術コラム>
新着情報: ウッドワード・ホフマン則に従う反応の瞬間を世界初観測～軟X線吸収分光という新たな視点で化学反応の基本法則を解明～（工学研究院　准教授　関川太郎）	<技術開発>,<研究>	<技術トピック>
岩崎電気とMIつくば、新型「グラフェンリチウムイオンキャパシタ」を活用した蓄電制御システムの実証実験を開始 - 日本経済新聞	<実験>,<市場動向>	<経済>
理科大、従来よりも簡便な多層カーボンナノチューブの配線作成手法を開発 (1)	<紹介>,<技術開発>	<技術トピック>
脱炭素化支援機構、今月末にも投資先決定／削減効果を多角的に評価 | 電気新聞ウェブサイト	<技術開発>,<業界情報>	<経済>
欧州は今後２回の冬も天然ガス確保に苦心＝エクイノールＣＥＯ（ロイター）		
ティグアンとゴルフ ヴァリアントの好感度が大幅アップ「4WDそしてディーゼル、それぞれに待った甲斐あり」【試乗】（Webモーターマガジン）	<コラム>	<tab不明-オピニオン>
米エネルギー省、鉄鋼・化学等部門のGHG排出削減のため約60億ドルの資金を提供(米国) | ビジネス短信 ―ジェトロの海外ニュース	<政府>,<技術提供>,<サービス開始>	<製品サービス>
今治市で廃棄物発電由来再エネ電力の自己託送開始【タクマ】より直接的な「地産地消」実現で電力コストの更なる安定化にも貢献	<サービス開始>,<コラム>,<技術開発>	<製品サービス>
かつて叩き売り状態で下取り価格もイマイチ……マツダオーナー過去の苦悩と今（ベストカーWeb）		
タンパク質の機能を模倣するヘテロポリマー設計	<技術開発>	<技術トピック>
無限層酸化物にも見つかったヤーン・テラー効果	<効果>	<技術トピック>
ホンダ、シビック受注停止｜自動車メーカー｜紙面記事	<障害>,<サービス終了>	<製品サービス>
農業・建設業などの車両向けに低電圧電気部品を供給＝米イートン〔ＢＷ〕：時事ドットコム	<利用・採用>	<技術トピック>
TET2は両刃の剣		
LiDARから保険　ルミナー、テスラ流で｢脱部品会社｣ - 日経モビリティ		
岩谷産業が陸上養殖の研究設備を導入、提案力強化へ	<方針>,<利用・採用>,<目標>,<技術開発>	<技術トピック>
【英国】英新車登録、２月は26％増加　前月から伸び加速＝ＳＭＭＴ（NNA）	<特許>,<商品化>,<社会統計>,<現象>	<製品サービス>
バイオ燃料でもいけた！ LPG船で使用し試験航行を完了！ 廃食用油などが原料（乗りものニュース）	<実験>	<技術トピック>
ある意味商用車の怪物！　軽やワンボックスが全盛でワゴンが下火のなか「プロボックス」が売れ続ける理由とは | goo - 自動車	<技術開発>,<コラム>	<技術コラム>
H3K4me3は転写開始ではなく転写伸長を調節する	<技術開発>,<コラム>	<技術コラム>
小型モビリティ用ライト、融雪マーカー、交換式高輝度LEDなどアイデア満載の小糸製作所…IAAE 2023 | レスポンス（Response.jp）		
坑井建設用セメントの代替低炭素技術を発表＝米ＳＬＢ〔ＢＷ〕：時事ドットコム	<技術開発>,<設備投資>	<経済>
ダウン症候群における自己免疫病態の機構	<技術開発>	<技術トピック>
住友ゴム社長「供給網全体で資源を循環させて有効利用する」…2030年サステナブル原材料比率40％に | レスポンス（Response.jp）	<利用・採用>,<コラム>,<社会統計>	<技術コラム>
丸住製紙、自社セルロースナノファイバーの抗菌性を確認 - 日本経済新聞	<技術開発>,<調査>,<研究>,<市場動向>	<経済>
東大・岡山大・弘前大、「量子液晶揺らぎによる電子対形成」の検証に成功 - 日本経済新聞	<研究>,<調査>,<市場動向>	<経済>
山火事のエアロゾルによるオゾン枯渇の激化	<技術開発>	<技術トピック>
細菌の外膜と細胞壁の生合成を調整する機構	<技術開発>	<技術トピック>
大阪公大、ニュートリノ質量の階層性を数学的に説明できることを提示	<コラム>	<tab不明-オピニオン>
石油市場は安定、懸念された欧州向け供給不足起こらず＝ガンバーＣＥＯ（ロイター）	<障害>,<コラム>	<社会>
【インタビュー】私たちがそれでも研究を続けてきた理由	<研究>	<技術トピック>
種間で異なる世代当たりの変異率		
セルロースナノファイバー「ステラファイン（STELLAFINE）」に抗菌性		
熱帯林の減少が降水量の大幅な減少をもたらす	<コラム>	<tab不明-オピニオン>
日産の新型「小型バン」がオシャすぎる！ 商用車の質感超えた!? 新型「タウンスター EV」オランダで発売 - トピックス｜Infoseekニュース	<コラム>,<背景>,<業界情報>,<社会統計>,<商品化>	<製品サービス>
中国の石炭火力は日本の20倍分で更に6倍分建設中		
即納されるトヨタ「ランドクルーザー300」!? 「キング・オブ・四駆」ランクルの迫力と存在感を徹底再現！ ディテールにこだわったモデルが発売（くるまのニュース）	<技術開発>,<商品化>	<製品サービス>
【関西在住者が選ぶ】乗っていると自慢できると思う「自動車メーカー・ブランド」ランキング！　2位は「メルセデス・ベンツ」、1位は？（ねとらぼ）	<コラム>,<見解>,<レポート>,<業界情報>	<経済>
NEDO　独立型ORC発電システム、出力と省エネ両立 – 日刊ケミカルニュース	<効果>	<技術トピック>
【アパレルDX】株式会社GOOD VIBES ONLYが開発する”Prock”にMD計画機能を新規リリース。新入社員でも使いこなせるシステムを目指す！	<技術開発>,<方針>,<目標>,<コラム>	<技術コラム>
使いやすいMastodonアプリIvory、新規アカウントがお手軽に作れるように！	<コラム>,<技術開発>	<技術コラム>
ウェルビーイングな未来のライフスタイルを探求する | 東京大学	<調査>,<コラム>	<tab不明-オピニオン>
【知財ビジネス】世界の特許を格付け・出品、ＡＩで可能に	<コラム>,<技術開発>	<技術コラム>
窓辺の小石(104) 危険な「過去」への旅		
編集者の視点　「脳と言語モデルは動きが違う」など3本 - 日経テックフォーサイト	<コラム>,<レポート>	<tab不明-オピニオン>
​没入度MAXのモバイル向け次世代タクティカルFPS『Arena Breakout』日本向けクローズドベータテスト開催中！撃って！奪って！脱出せよ！	<イベント>,<実験>,<社会事件>	<イベント>
ハイブリッドテクノロジーズ AIを中心とした先端技術を社会実装し、UDXの実現を目指す Intelligence Design株式会社のAIエンジニア体制の構築、アノテーション業務を支援	<技術開発>,<コラム>,<時制.未来>,<設立>,<設備投資>,<支援>	<経済>
Microsoftが狙う創薬テック16兆円市場　AIで開発支援 - 日本経済新聞	<コラム>,<市場動向>,<支援>	<経済>
ブランド、そして人材を世界に飛躍させる発射台になりたい。MOON-X代表 長谷川晋インタビュー（ライフハッカー・ジャパン）	<コラム>	<tab不明-オピニオン>
【Vite*Vue3】コンポーネントライブラリを自作してnpmに公開する手順	<イベント>	<イベント>
ルネサス、Cortex-M85マイコンでのAI実装デモをembedded world 2023にて公開	<実験>	<技術トピック>
小型SAR衛星開発のQPS研究所が約10億円、搭乗型ロボット開発のMOVeLOTが2500万円の資金調達（DIAMOND SIGNAL）	<投資>,<資金>	<経済>
実績に基づいたベストプラクティスでクラウド移行の課題解決をサポート	<技術開発>,<支援>	<経済>
いま産業用機械・機器製造業に求められるITプラットフォームの要件	<要望>,<要請>	<政治>
WebGL(by Unity)×Agora Web SDKで音声通話アプリの開発	<技術開発>	<技術トピック>
AIで3D空間を自動生成「Matterport製品紹介セミナー」開催のお知らせ	<商品化>	<製品サービス>
nizima Liveとは？LIVE2D公式ソフト特徴から使い方まで詳しく紹介！	<コラム>,<イベント>,<紹介>	<イベント>
エンジニア文化祭2023に参加した感想	<意見>	<tab不明-オピニオン>
LINE × Launchable - Developer Test安定化と高速化へのアプローチ (2023/03/30 12:00〜)		
SupermicroとRakuten Symphonyがコラボレーション クラウドベースのOpen RANモバイル・ネットワーク向け 5G、テレコ、エッジソリューションを提供	<提携>,<技術提供>,<サービス開始>	<製品サービス>
GuildQB、TEAMZ WEB3.0 SUMMIT 2023にコミュニティサポーターとして参加決定！	<イベント>,<政府・会談>,<方針>	<政治>
Lenovo、Aston Martinと共同設計した最大120コアの第4世代Xeon SP搭載ワークステーション（Impress Watch）	<技術開発>	<技術トピック>
「何から学んだか」を具体例で示すことでAIの判断が説明可能に　立教大学	<コラム>,<技術開発>	<技術コラム>
コイン2枚を投げて「2枚とも表」になる確率は何%か？うっかり間違えがちな「確率」の基礎知識（幻冬舎ゴールドオンライン）	<社会統計>,<コラム>	<社会>
血糖値の測り方が変われば糖尿病のケアが変わる	<コラム>	<tab不明-オピニオン>
フリービット、web3のコア技術であるblockchainの諸問題を解消する「freebit web3 Blocks」とその実績、今後の展開を発表。	<業界情報>,<方針>	<経済>
企業向けNFT生成プラットフォーム『NFT Garden』は新規4チェーン Harmony, Celo, Fuse, EvmosでのNFT生成に対応し アジア最大級となる16種チェーン対応に	<技術開発>,<コラム>	<技術コラム>
ホンダ発・Ashiraseが挑む｢福祉業界｣の難題。｢バカなこと｣と言われてもやる	<コラム>	<tab不明-オピニオン>
Starknet上でのパーペチュアルDEX構築を目指す「ZKX」とは？	<設備投資>,<コラム>	<経済>
ビッグデータは本当に「死んだ」のか。（佐藤哲也） - 個人 - Yahoo!ニュース	<コラム>	<tab不明-オピニオン>
オムロン サイニックエックスの米谷 竜が、「2022年度 電子情報通信学会 教育功労賞」を受賞	<表彰>	<社会>
ＥＣＢ、サイバー攻撃に対するストレステストを来年実施へ	<実験>,<目標>	<技術トピック>
ゼロからはじめるAzure(49) Azureでコンテナ化アプリを動かしてみよう その8	<コラム>	<tab不明-オピニオン>
輝け！スタートアップ（161）TAI　エッジAIで現場効率化	<コラム>,<技術開発>	<技術コラム>
メタバースで新車が買える!? 日産×東京日産の実証実験「NISSAN HYPE LAB」が6月30日まで一般公開	<コラム>,<イベント>	<イベント>
ATMを狙う新しいマルウェア発見、外部キーボードを接続して感染か	<研究>,<障害>,<社会事件>	<技術トピック>
JSAC2023 開催レポート～DAY 2～	<イベント>,<レポート>	<イベント>
【ワイヤレス給電 建築DX】清水建設と共創でビルIoTを推進。SHIMZ NEXTイノベーターとしてCity-Tech.Tokyoイベントに登壇しました。	<方針>,<設備投資>,<セミナー>,<コラム>	<経済>
Amazon Location ServiceのMapをAPI Keyで表示する	<コラム>	<tab不明-オピニオン>
【セキュリティ ニュース】macOS向け音楽制作ソフト「GarageBand」に複数の脆弱性（1ページ目 / 全1ページ）：Security NEXT		
【Gainsight共催】解約率改善後の一手 トップランナーの見据えるCS戦略 (2023/03/27 16:00〜)	<方針>,<戦略>	<tab不明-トピック>
手間のかかる通話内容の聞き起こし作業や分析プロセスを簡単に　クラウド型CTIコールセンターシステム「COLLABOS PHONE」と顧客管理・営業支援システム「Zoho ...	<コラム>	<tab不明-オピニオン>
Snapdragon 8 Gen 3の詳細構成情報が投稿、やはりA16超の性能実現？	<技術開発>,<コラム>,<市場動向>	<経済>
三井化学、人工肩関節デバイス・ソフトウェア開発のShoulder Innovationsへ投資｜2023｜ニュースリリース｜三井化学株式会社	<投資>	<経済>
エンジニアになるということ。	<コラム>	<tab不明-オピニオン>
春から情報管理を始めたい方必見！GROWIのセットアップ方法を徹底解説 (2023/04/17 15:00〜)	<コラム>	<tab不明-オピニオン>
ASUSのRyzen 7 5800H搭載16型ノートPC「Vivobook」が楽天スーパーDEALでポイントバック30％！（Impress Watch）		
「Sui（SUI）」上にMMOゲーム「Trantorian」構築へ、ミステンラボとインデルベ提携で（あたらしい経済）	<設備投資>,<目標>,<市場動向>	<経済>
「Leafony」実装、進む　効率的な開発や多様なアプリケーション　トリリオンノード研究会で披露 　「ナノコン」代表格として期待 | 電波新聞デジタル	<技術開発>,<業界情報>,<イベント>,<研究>,<見解>,<要望>	<経済>
21年度化粧品通販売上高、市場規模は8%増　上位85社総計5933億円、市場成長率が復調の兆し	<商品化>,<市場データ>,<技術開発>,<業績>,<投資>	<製品サービス>
エーザイ・内藤CEO　バリューベース実現で「日本の製薬産業の閉塞感打破」　透明度高い議論を | ニュース | ミクスOnline	<コラム>,<政府・会談>	<政治>
Microsoftが狙う創薬テック16兆円市場　AIで開発支援 - 日本経済新聞	<コラム>,<市場動向>,<支援>	<経済>
プレスリリース・タイトルリスト　2023/03/10｜薬事日報ウェブサイト	<レポート>	<tab不明-レポート>
ダイドーGHD 価格改定効果に手応え 自販機の利便性に支持 - 食品新聞 WEB版（食品新聞社）	<コラム>,<生活>	<tab不明-オピニオン>
米大手百貨店の22年11月～23年1月決算　減収基調、全社が減益 | 繊研新聞	<業績>	<経済>
「ガリガリ君」20年ぶり刷新　純氷使用で爽快さアップ　赤城乳業（食品新聞）	<サービス更新>	<製品サービス>
専門店やネット通販と激しく競合し苦戦、イトーヨーカ堂が今後３年間で３３店削減	<技術開発>	<技術トピック>
【知財ビジネス】世界の特許を格付け・出品、ＡＩで可能に	<コラム>,<技術開発>	<技術コラム>
(株)JTBと(株)スマートヘルスネット（(株)ＴＢグループ100％子会社）と基本契約締結に関するお知らせ｜共同通信PRワイヤー｜奈良新聞デジタル	<契約>	<経済>
タマノイ酢、業務用すし酢20L全11品を値上げ - 日本食糧新聞電子版	<価格変更>	<製品サービス>
子癇前症診断市場（Preeclampsia Diagnostics Market）に関する調査は、2022 年のランドスケープを理解するために実施されました。	<コラム>,<方針>,<調査>	<tab不明-オピニオン>
REI Co-op、1,000社以上のブランドパートナーに対して、社会的・環境的な取り組みを推進するための新たな製品基準を発表	<方針>,<商品化>	<製品サービス>
「日本人を最も殺す」2人に1人の恐怖…平均費用“1日8万円”の衝撃 - 記事詳細｜Infoseekニュース	<コラム>	<tab不明-オピニオン>
長時間の空腹避ける工夫を　神タク協・研修会｜労働新聞 ニュース｜労働新聞社	<イベント>	<イベント>
データで読み・解き・探る食の今：23年1月度販売動向 - 日本食糧新聞電子版	<コラム>,<商品化>	<製品サービス>
グッドファクトリー賞、ダイキンなど5社が受賞　各工場の改革活動と成果を評価 | 電波新聞デジタル	<表彰>,<業界情報>	<経済>
【記者のひとこと】社名変更後も堅調に推移 - BCN＋R	<コラム>,<株式概況>,<市場動向>	<経済>
特許の崖を乗り越えた【アステラス】  新社長に副社長の岡村副社長	<コラム>	<tab不明-オピニオン>
ネスレ、ペットフード生産増強に65億バーツ | タイ経済・ビジネスニュース: 日刊タイビジネス	<市場動向>,<コラム>	<経済>
アダストリア、3年ぶり高値　売り上げ拡大に期待高まる - 日本経済新聞	<株式概況>,<コラム>,<市場動向>	<経済>
フランスにおける味噌づくり、多様な原材料や低塩分が特徴(日本、フランス) | ビジネス短信 ―ジェトロの海外ニュース	<コラム>	<tab不明-オピニオン>
【トラストファーマテック】25年までに年20億錠生産‐来月から本格生産開始｜薬事日報ウェブサイト	<生産活動>	<製品サービス>
実店舗とECの売り逃しを一挙に解消　ナラカミーチェ3つの秘策	<技術開発>	<技術トピック>
ビール系販売2月は3%増　大手4社、業務用回復 - 日本経済新聞	<市場データ>,<業績>,<提携>,<市場動向>	<経済>
イートアンドフーズ、春夏商品新9品・リニューアル11品発売　プチ贅沢と経済性着目 - 日本食糧新聞電子版	<商品化>,<市場動向>,<技術開発>	<製品サービス>
中国・京東、2期ぶり黒字転換　前期最終2000億円 - 日本経済新聞	<方針>,<投資>,<市場動向>	<経済>
英研究、1日10分程度の「早歩き」に心臓病リスクを減らす効果 - ネット「たった10分でも違う！」	<研究>,<技術開発>,<効果>	<技術トピック>
妊娠率改善「子宮内フローラ検査」を開発　Varinosが持つ技術優位性 | Forbes JAPAN 公式サイト（フォーブス ジャパン）	<技術開発>,<コラム>	<技術コラム>
バイエル、売上高と利益の大幅な成長を達成	<業界情報>	<経済>
ソフトバンクウェビナー／顧客満足度向上「ゴディバ流 小売DX」解説、3／22開催	<説明>,<セミナー>	<イベント>
オムロン・JMDC・日本生命・三井住友銀行など、「健康経営アライアンス」を設立 - 日本経済新聞	<設立>,<市場動向>	<経済>
１月消費、前年比０．３％減＝旅行・外食増で前月比はプラス	<社会統計>,<市場データ>	<経済>
コカ・コーラ ボトラーズジャパンがAI・データ活用で得た驚きの成果（JBpress）	<業界情報>	<経済>
三井物産出資の香港ボウタイ、医療保険でアジア展開検討 - 日本経済新聞	<業界情報>,<方針>,<市場動向>	<経済>
ジョンズホプキンス大学、大規模「AIヘルシーエイジング研究」	<研究>	<技術トピック>
ＳＯＭＰＯは「SX」で進化する――金融業界が創る新たな経済・社会価値に期待 | JDIR	<コラム>,<技術動向>,<市場動向>	<経済>
接種と死亡「関係否定できず」	<コラム>	<tab不明-オピニオン>
企業が“フェムテック”を導入しない理由は「よく知らないから」が上位に	<コラム>,<業界情報>,<レポート>	<経済>
アサヒビールは複数ブランド戦略＝ＲＴＤ、シェア争い激化 - 日本食糧新聞電子版	<戦略>,<技術開発>	<技術トピック>
ロート製薬「ベレアラボ」代表・星氏に聞く、兼務人材がハブになる事業開発──組織能力の発見と統合とは？ | Biz/Zine	<対談>,<コラム>,<技術開発>	<技術コラム>
加藤産業、「カンピー　果物仕上げ」発売 - 日本食糧新聞電子版	<商品化>	<製品サービス>
障がい者モデルの活動を支援、日本発のモデルエージェンシーが本格始動	<支援>	<経済>
大丸松坂屋百貨店／ファッションサブスク３２７％成長／メンズ事業拡大（2023年3月9日号） | 通販 | 日本流通産業新聞 | 日流ウェブ	<方針>	<tab不明-トピック>
食品ロスを「HELAS（ヘラス）」　スマホで店舗と消費者つなぐ　信濃毎日新聞社と長野市が５月に実証実験	<実験>	<技術トピック>
持続可能な世界をオフィスからつくる──プリンターのリーディングカンパニーがサポートする企業のCO2削減	<コラム>,<技術開発>	<技術コラム>
人形町今半、老舗飲食店の丁寧な接客がECサイトでも好評 コロナ禍に売上2倍	<市場動向>	<経済>
ＲＴＤ発売加速　第３のビール増税前に主導権争い	<方針>	<tab不明-トピック>
補聴器のスタートアップ「オリーブユニオン」、米国で１億ドルの契約	<契約>,<受注>	<製品サービス>
豊田通商、中古車輸出のカーペイディーエムを子会社化 - 日本経済新聞	<技術開発>,<市場動向>	<経済>
メタバースで新車が買える!? 日産×東京日産の実証実験「NISSAN HYPE LAB」が6月30日まで一般公開	<コラム>,<イベント>	<イベント>
ルネサス、Cortex-M85マイコンでのAI実装デモをembedded world 2023にて公開	<実験>	<技術トピック>
【アパレルDX】株式会社GOOD VIBES ONLYが開発する”Prock”にMD計画機能を新規リリース。新入社員でも使いこなせるシステムを目指す！	<技術開発>,<方針>,<目標>,<コラム>	<技術コラム>
AIで3D空間を自動生成「Matterport製品紹介セミナー」開催のお知らせ	<商品化>	<製品サービス>
Salesforce、CRM向け生成AI「Einstein GPT」を発表	<技術開発>	<技術トピック>
THKが「部品予兆検知AIソリューション」提供、しきい値設定など一切不要に | 電波新聞デジタル		
playknotとVirtuloc社が戦略的パートナーシップ契約を締結！ノーコードで簡単にメタバース設計が可能なサービス提供を開始 | THE OWNER	<契約>,<受注>,<サービス開始>	<製品サービス>
Coherent、業界初200G PAM4 MZMレーザ技術デモ | e.x.press	<実験>	<技術トピック>
ジェネレーティブAI広告プラットフォーム【Omneky】、ChatGPT APIを活用したクリエイティブ生成ツール"Creative Assistant"をローンチ	<商品化>	<製品サービス>
SupermicroとRakuten Symphonyがコラボレーション クラウドベースのOpen RANモバイル・ネットワーク向け 5G、テレコ、エッジソリューションを提供	<提携>,<技術提供>,<サービス開始>	<製品サービス>
バルテス・モバイルテクノロジー、株式会社between the artsへ出資	<政府・補助金>,<支援>,<投資>	<政治>
NTTデータ、調達・購買プラットフォームを活用して購買システムを更改	<資金>	<経済>
スマホ搭載に近づくイベントベースセンサー（EE Times Japan）		
Lenovo、Aston Martinと共同設計した最大120コアの第4世代Xeon SP搭載ワークステーション（Impress Watch）	<技術開発>	<技術トピック>
米Amprius Technologies、ギガワット時規模のバッテリー工場用地としてコロラド州を選定	<表彰>	<社会>
ブロードエンタープライズ　アーキテクト・ディベロッパーにBRO-LOCKの提供を開始 |  財経新聞	<サービス開始>,<技術提供>	<製品サービス>
手間のかかる通話内容の聞き起こし作業や分析プロセスを簡単に　クラウド型CTIコールセンターシステム「COLLABOS PHONE」と顧客管理・営業支援システム「Zoho ...	<コラム>	<tab不明-オピニオン>
ソナタ・ソフトウェア、企業検索ソリューションの拡張を目的としたSinequa社との世界規模のパートナーシップを発表	<コラム>	<tab不明-オピニオン>
『 Metareal AI 』 発表。ChatGPT等を５千社超の顧客基盤から活用推進　生成系AIをはじめとした膨大なAI製品群を統一プラットフォームでワンストップ提供を目指す	<技術開発>,<利用・採用>,<方針>,<技術提供>,<サービス開始>,<コラム>,<時制.未来>	<製品サービス>
ジーニー　「GENIEE CHAT」に「ChatGPTメッセージ作成」機能を追加、コスト1/3削減 |  財経新聞	<サービス開始>,<技術開発>	<製品サービス>
東京都によるスタートアップ支援「NEXs Tokyo」のJUMP企業に、海外展示会で活躍するクレジットカードを用いた決済プラットフォームを運営する「RemitAid」が採択	<利用・採用>	<技術トピック>
自動車業界の持続可能性と軽量化に関する賞の応募受け付けを開始		
欧州向けに定額制ＩｏＴ接続パッケージを発表＝中国クエクテル〔ＢＷ〕：時事ドットコム		
LINE公式アカウントでもChatGPTが利用可能に！クレッシェンド・ラボが「CAAC AI」対話サービスを展開	<技術開発>,<業界情報>,<方針>	<経済>
テレシー 、「Best Venture100 カンファレンス 2023年 Spring」に協賛	<支援>	<経済>
日産、メタバースでクルマの検討から試乗・購入の契約まで行う実証実験	<契約>,<受注>,<実験>	<製品サービス>
Hyper Photonix、OFC2023でSiPh 400G　DR4発表 | e.x.press		
Coherent、OFCで800G/1.6Tトランシーバ向け200G/レーンをデモ | e.x.press	<実験>	<技術トピック>
オープンソースの統合監視ソフト「Zabbix」最新版v6.4リリース		
ＡＩに炭素排出の死角、開発に大量電力消費－透明性拡大が課題に（Bloomberg）	<コラム>,<社会問題>	<社会>
“AVアンプができるまで” 動画で撮影してみた（Impress Watch）	<コラム>	<tab不明-オピニオン>
いま産業用機械・機器製造業に求められるITプラットフォームの要件	<要望>,<要請>	<政治>
トピックス2023 年 3 月 10 日 
株 式 会 社 NT T ド コ モFitbit ブラン	<イベント>	<イベント>
DuckDuckGo、AI検索機能「DuckAssist」を発表--OpenAIなどの技術を活用	<技術開発>	<技術トピック>
レノボ、圧倒的なパフォーマンス、パワー、スピードを誇る「ThinkStation PX／P7／P5」を発表		
フリービット、web3のコア技術であるblockchainの諸問題を解消する「freebit web3 Blocks」とその実績、今後の展開を発表。	<業界情報>,<方針>	<経済>
​没入度MAXのモバイル向け次世代タクティカルFPS『Arena Breakout』日本向けクローズドベータテスト開催中！撃って！奪って！脱出せよ！	<イベント>,<実験>,<社会事件>	<イベント>
Starknet上でのパーペチュアルDEX構築を目指す「ZKX」とは？	<設備投資>,<コラム>	<経済>
State Grid Zhejiang Electric Power Company：杭州アジア大会のグリーン電力取引が5億キロワット時に到達		
LINE × Launchable - Developer Test安定化と高速化へのアプローチ (2023/03/30 12:00〜)		
リコーとコペルニク、日本科学未来館で「360°映像で体験するSDGs～遠くの国の課題も同じ地球のできごと～」を開催 | THE OWNER	<イベント>	<イベント>
《日経Robotics》Preferredが消費者向けロボット市場に参入、月額約5千円で家庭内の搬送プラットフォームに	<サービス開始>	<製品サービス>
GuildQB、TEAMZ WEB3.0 SUMMIT 2023にコミュニティサポーターとして参加決定！	<イベント>,<政府・会談>,<方針>	<政治>
D-EDGEはホスピタリティー業界のリーディングパートナーと連携し、デジタルテクノロジーによる業務効率改善をテーマにしたワークショップを開催	<提携>,<イベント>	<経済>
新規事業担当者必見--Sun Asteriskが明かす、400の共創事例から明らかになった成功の秘訣	<コラム>	<tab不明-オピニオン>
IFS の設備資産管理（EAM）を 選ぶ10の理由	<コラム>	<tab不明-オピニオン>
使いやすいMastodonアプリIvory、新規アカウントがお手軽に作れるように！	<コラム>,<技術開発>	<技術コラム>
近日リリース：仕事に必要なChatGPTの全てがここに「CalqWorks」	<サービス開始>	<製品サービス>
ヒューメインがシリーズCラウンドで1億ドルを調達し、AI時代のデバイスとサービスプラットフォームを構築	<資金>,<設備投資>	<経済>
半導体製造装置メーカーのＡＳＭＰＴ買収にＰＥ会社が関心－関係者（Bloomberg）	<方針>,<譲渡・買収>,<生産活動>,<技術開発>,<コラム>	<製品サービス>
2023年、新設電源の54％が太陽光		
NIMSの新材料開発システム、秘密主義の日本企業が世界に勝つための工夫とは	<コラム>	<tab不明-オピニオン>
家庭用蓄電池によるDR実証を開始【伊藤忠商事】冬季の電力需給逼迫を回避	<実験>	<技術トピック>
カナダのスタートアップ・アセルタ、日産と共同開発の故障予測プラットフォーム完成を発表(日本、カナダ) | ビジネス短信 ―ジェトロの海外ニュース	<予測>,<技術開発>	<技術コラム>
〈アドテク〉日産、EV・HVのパワートレイン　モジュール化やレアアース削減　サプライヤーの開発力を活用｜自動車メーカー｜紙面記事	<技術開発>,<コラム>	<技術コラム>
エネルギーリスクマネジメントの進め方	<コラム>	<tab不明-オピニオン>
そのうちガソリン車レベルに? 日産の電動車コストダウン作戦が進展	<コラム>,<イベント>	<イベント>
環境負荷の少ないLNGトラックが北海道を走行中！<br/>～極低温技術を活用した充填設備が活躍～ | Meet with AW!	<コラム>	<tab不明-オピニオン>
JERA、豪州・米国でCCS検討　ガス田など候補地 - 日経GX	<コラム>	<tab不明-オピニオン>
東大、電通大と共同で通常とは異なる性質を持つ磁性体の開発に成功 - 日本経済新聞	<技術開発>,<市場動向>	<経済>
室温でMg蓄電池から高エネルギー　東北大などの研究グループが新正極材料　ポストLIB実現へ大きな一歩 | 電波新聞デジタル	<技術開発>	<技術トピック>
マツダ CX-3 | これがオーナーの本音レビュー! 「燃費は? 長所は? 短所は?」 | モーターファン会員アンケート￼（MotorFan）	<レポート>,<コラム>	<tab不明-オピニオン>
東京大学、ガラスの構造変化を高精度予測　深層学習活用 - 日経テックフォーサイト	<予測>,<技術開発>,<利用・採用>	<技術コラム>
イーアクスルコスト競争　日産3割安く、日本電産35%減 - 日経モビリティ	<市場データ>	<経済>
MR-S以来久々のスポーツカーで四苦八苦!?　初代86は当初ディーラーマンがアタマ抱えたってマジ!?（ベストカーWeb）	<コラム>	<tab不明-オピニオン>
エネルギーの地産地消、地球温暖化の永久解決「CO2を回収するフィルター」で目指す未来（ABEMA TIMES）	<コラム>,<方針>,<目標>	<tab不明-オピニオン>
オーダー停止から無事復活！ 「日産GT-R」の延命に思うこと（webCG）	<サービス開始>,<サービス更新>,<見解>,<コラム>	<製品サービス>
道を創る　脱炭素社会へ　横山興業　自家消費型太陽光発電を導入　勉強会で脱炭素学ぶ　アップサイクル商品も開発	<コラム>,<目標>,<方針>,<利用・採用>,<技術開発>	<技術コラム>
韓国自動車記者協会、「3月の車」に「トヨタ」選定	<表彰>	<社会>
三菱自動車、新たな軽乗用車投入を予告 新中期経営計画「Challenge 2025」でグローバル16車種を今後5年間に投入（Impress Watch）	<利用・採用>	<技術トピック>
気候工学、微粒子まき温暖化防ぐ　米社が実験して物議に - 日本経済新聞	<技術開発>,<実験>,<市場動向>	<経済>
車格と装備内容を考えてみれば、コスパも高いトヨタ「カローラ クロス」		
フォルクスワーゲンEVミニバン「ID.バズ」日本導入決定！　欧州で大人気　2024年末以降に（AUTOCAR JAPAN）	<方針>,<利用・採用>	<技術トピック>
血糖値の測り方が変われば糖尿病のケアが変わる	<コラム>	<tab不明-オピニオン>
《日の丸半導体復活となるか？》『ラピダス』が北海道に次世代半導体の新工場建設へ	<コラム>,<設備投資>,<目標>	<経済>
車載AI半導体で自立、｢中国版Nvidia｣ホライズンの実力 - 日経モビリティ	<コラム>	<tab不明-オピニオン>
三菱自、執行役員・その他重要人事について発表	<人事>,<コラム>	<経済>
Chill CARS｜時代の要請に応えて生まれた、ポップなコンパクトカー。（Casa BRUTUS.com）	<社会情勢>	<社会>
核融合科学研究所と東邦金属／核融合炉用高熱負荷機器を開発／新「異種金属接合法」活用 | 日刊鉄鋼新聞 Japan Metal Daily	<技術開発>,<利用・採用>	<技術トピック>
蒲郡市公共施設ＬＥＤ化整備進捗状況について - 愛知県蒲郡市公式ホームページ	<コラム>	<tab不明-オピニオン>
唯一無二の減速機で技術革新を支える ―空や宇宙、地底から医療現場まで活躍する製品 ニュースイッチ by 日刊工業新聞社	<コラム>	<tab不明-オピニオン>
関市と日産自動車、電気自動車を活用した脱炭素化及び災害に強いまちづくりに関する連携協定を締結	<契約>,<受注>	<製品サービス>
CO2削減貢献量、東レが30年度8倍　「GX材料」R&D拠点 - 日経GX	<市場データ>,<設備投資>	<経済>
気候工学　微粒子まき温暖化防ぐ - 日本経済新聞	<技術開発>,<コラム>,<市場動向>	<経済>
【ＥＳＧまとめ読み】脱炭素なのに数値悪化、女性幹部が多数退職	<技術開発>	<技術トピック>
新型CX-80の全貌判明!?　輸入車から乗り換えでも納得のデキの予感（ベストカーWeb）	<技術開発>,<コラム>	<技術コラム>
新着情報: メカノケミカル有機合成反応に特化した触媒の開発に成功～有機溶媒の使用量を低減する環境調和型物質生産プロセスの拡充へ～（創成研究機構化学反応創成研究拠点　教授　伊藤　肇、准教授　久保田浩司）	<技術開発>,<効果>,<生産活動>,<目標>,<設備投資>	<製品サービス>
今すぐ行動を起こすためにビジネス課題、機会、そして ユースケースを徹底解説	<イベント>,<説明>	<イベント>
〈マーケット最前線〉マルカサービス　アルミホイールの新ブランド「MTW」　第1弾はテスラ専用｜企画・解説・オピニオン｜紙面記事	<サービス開始>	<製品サービス>
トヨタ、新型「C-HR」はいつ発売？ 「新型プリウスに似てる…」反響は？  全面刷新で「ハンマーヘッド顔」採用、豪州は24年前半に導入へ（くるまのニュース）	<商品化>,<コラム>,<利用・採用>,<方針>	<製品サービス>
京都大、室温で高温超伝導モーターの運転に成功	<技術開発>	<技術トピック>
省エネ計算にワクワク感を、設計者がつくったBIMサービス	<コラム>,<サービス開始>	<製品サービス>
ポリ（3-ヒドロキシブチレート-co-4-ヒドロキシブチレート）から成る高伸縮性吸収性モノフィラメント縫合糸		
EV新潮流：鴻海がEV事業に新境地　水平分業でEV開発コストを3分の1に　湯進 | 週刊エコノミスト Online	<コラム>	<tab不明-オピニオン>
宇宙から見たビジネス#13：SDGsとの関係	<見解>,<コラム>	<tab不明-オピニオン>
ホンダ新型「GB350」「GB350S」登場！ ホワイトで新鮮な印象に……正式発表はもうすぐ？（WEBヤングマシン）	<商品化>,<コラム>	<製品サービス>
KINTOのクルマで事故！　保険は大丈夫だったのか？！【GR86：エンジン編集部の長期リポート番外篇 #2】（ENGINE WEB）	<障害>,<社会事件>,<コラム>	<社会>
NextDrive 「スマートグリッドEXPO 春」出展のお知らせ	<イベント>	<イベント>
宇宙は複数存在するのか? 多元宇宙研究アプローチの現実　シドニー大教授の研究 |  財経新聞	<研究>	<技術トピック>
【日本】味の素、キリン等8社、健康経営アライアンス発足へ。ヘルスケアデータ活用で国家課題も解決 | Sustainable Japan | 世界のサステナビリティ・ESG投資・SDGs	<レポート>,<提携>,<設立>,<目標>,<コラム>,<技術開発>,<投資>,<社会問題>	<経済>
不二製油グループ本社社長「量から質へ」意識改革を率先 - 日本経済新聞	<市場動向>	<経済>
もうけの仕組み｜トイレタリー／家具／アパレル／リユース	<コラム>	<tab不明-オピニオン>
JCU社長 木村昌志氏 ―― トップに聞く	<コラム>,<対談>	<その他>
知っておくべき「慢性疲労」の一般的な5つのサイン（ウィメンズヘルス）	<コラム>	<tab不明-オピニオン>
脳トレ「川島研究室」の警鐘、ネット依存はアルコール依存と同様に危険（JBpress）		
水戻し不要の代替肉生産強化へ、亀田製菓（新潟江南区）子会社「マイセンファインフード」が新工場　欧州製加工機器を国内初導入	<生産活動>,<目標>,<設備投資>,<方針>,<利用・採用>	<製品サービス>
【教員の「こころ」を守る（3）】沖縄からスタートした「教職員のメンタルヘルスプロジェクト」	<コラム>,<戦略>,<サービス開始>,<設立>	<製品サービス>
コンビニnews｜2月既存店セブン3.9%増･ファミマ4.8%増･ローソン8.4%増 – 流通スーパーニュース	<市場データ>	<経済>
7-Eleven／Speedwayとの統合で、2023年度に8億ドルのシナジー見込む	<コラム>	<tab不明-オピニオン>
65歳以上の認知症患者は「5人に1人」になる？ 介護費用はいくら準備すればいい？（ファイナンシャルフィールド）	<コラム>	<tab不明-オピニオン>
オーマイ　うれしい自然の恵み　植物うまれの　＜カルボナーラ＞（ニップン）2023年2月20日発売 - 日本食糧新聞電子版	<商品化>	<製品サービス>
うつ病になる人の腸内細菌には、ある特徴がある	<コラム>	<tab不明-オピニオン>
避難場所の機能拡充を　災害時のストレス低減　コミュニティーデザイナー、工学博士　中山友紀（藤岡市下戸塚） | 上毛新聞社のニュースサイト	<社会事件>,<効果>	<技術トピック>
シンポジウム プラスチック資源循環の近未来｜東京都	<コラム>	<tab不明-オピニオン>
2023 年 3 月 10 日各位EPS ホールディングス株式会社ロゴスサイエンス株式会社EPS ホ		
オーマイ　うれしい自然の恵み　植物うまれの　＜ボロネーゼ＞（ニップン）2023年2月20日発売 - 日本食糧新聞電子版	<商品化>	<製品サービス>
村田製作所、工場の脱炭素に営業視点　日本にこそ商機 - 日本経済新聞	<技術開発>,<市場動向>	<経済>
温室効果ガス削減、「1社で目標達成難しい」　　アステラス・飯野部門長 | 日刊薬業 - 医薬品産業の総合情報サイト	<技術開発>,<コラム>	<技術コラム>
サーティワンが過去最高の売上高を達成　ジョン・キム氏会長兼社長CEO「記録的な1年だった」（食品新聞）	<目標>,<コラム>	<tab不明-オピニオン>
【障害福祉業界初】身体障がい者のためのオンライン就労支援サービスを2023年3月開始：時事ドットコム	<障害>,<サービス開始>	<製品サービス>
八木通商が「シーピー カンパニー」のマスターライセンス取得　24年1月には東京に旗艦店（WWDJAPAN.com）		
食品ロス削減 ネットワーク拡大を　岡山でシンポ、参加者が事例報告：山陽新聞デジタル｜さんデジ	<生活>,<技術開発>,<方針>,<情報公開>	<経済>
異業種8社がタッグ　垣根を越え社員のヘルスケア　健康保険組合の財政健全化目指す（テレビ朝日系（ANN））	<方針>,<目標>	<tab不明-トピック>
知ってた？スーパーよりも「卵」を安く買える場所（クックパッドニュース）	<コラム>	<tab不明-オピニオン>
ハイチュウプレミアム　＜北海道メロン＞（森永製菓）2023年2月14日発売 - 日本食糧新聞電子版	<商品化>	<製品サービス>
栄のラシックにリニューアルした「KITANO ACE」　小容量・個食・簡便商品も（みんなの経済新聞ネットワーク）	<サービス更新>	<製品サービス>
アメリカ人は植物由来肉を食べなくなった…消費者の認知度アップが頼みの綱か	<コラム>	<tab不明-オピニオン>
ニップン　よくばりプレート＜豆腐から作ったお肉のミラノ風ドリア＆カポナータ＞（ニップン）2023年3月1日発売 - 日本食糧新聞電子版	<商品化>	<製品サービス>
1月消費者物価、前年比4.1％上昇　山形市、伸び率高止まり	<社会統計>	<社会>
地域ブランド「古今東北」売り上げ好調　みやぎ生協など復興支援へ設立、売上高３倍に　#知り続ける（河北新報）	<市場動向>,<設立>,<コラム>	<経済>
新・医薬品品質保証こぼれ話【第23話】 | GMP Platform	<コラム>	<tab不明-オピニオン>
オーマイ　＜2種のスパゲッティ ナポリタン＆焼きそばソース＞（ニップン）2023年3月1日発売 - 日本食糧新聞電子版	<商品化>	<製品サービス>
飲食業界の将来性はいかに？　山積みの課題と生き残り策	<コラム>	<tab不明-オピニオン>
春の食卓が華やぐ新定番アイテム5（食楽web）		
オムロン・キリンなど8社、社員の健康促進で連携 - 日本経済新聞	<提携>,<市場動向>	<経済>
価格高騰の「卵」　追い打ちをかける鳥インフル拡大と背景にある「日本の養鶏の劣悪な環境」 - トピックス｜Infoseekニュース	<コラム>	<tab不明-オピニオン>
赤ちゃんの難病に早期対応が可能　有料検査「拡大新生児スクリーニング」の周知を群馬県が呼びかけ | 上毛新聞社のニュースサイト	<技術開発>	<技術トピック>
政府 コロナ5類移行後 最大6万4000の医療機関で受け入れ目指す | NHK	<政府>,<方針>,<目標>,<コラム>	<政治>
米国とインド、半導体で協力覚書　供給網・研究開発で（写真=AP） - 日本経済新聞	<契約>,<技術開発>,<研究>,<市場動向>	<経済>
イノベーション研究助成 | リリー教育・研究助成事務局 | さらなる貢献へ | 日本イーライリリー	<コラム>,<技術開発>,<目標>	<技術コラム>
ニップン　アマニ油入りドレッシング　＜フレンチ風クリーミー＞（ニップン）2023年2月20日発売 - 日本食糧新聞電子版	<商品化>	<製品サービス>
書籍「こんな会社で働きたい」に掲載されました | NEWS | 株式会社アイセロ	<コラム>	<tab不明-オピニオン>
商品の「プレミアム化」が止まらない　購買力のない者を締め出し、お金と購買欲のある消費者を中心とする経済へ（クーリエ・ジャポン）	<コラム>,<市場動向>	<経済>
コロナ対策、マスク着用ルール緩和後のチェックリスト公開　順天堂大学	<イベント>	<イベント>
味にも理念にも納得！「people tree」のチョコをリピ買い中｜Mart（magacol）	<コラム>	<tab不明-オピニオン>
オーマイプレミアム　＜うま塩レモン＞（ニップン）2023年3月1日発売 - 日本食糧新聞電子版	<商品化>	<製品サービス>
あなたの手元にあるその「データ」、じつは「比較という方法」によって何倍にも有効活用できます（荻原 和樹）	<技術開発>,<利用・採用>,<コラム>	<技術コラム>
クラウドに関する記事のまとめ(2023.3.5～2023.3.11）：『ビジネス2.0』の視点：オルタナティブ・ブログ	<コラム>	<tab不明-オピニオン>
ラボにおけるERESとCSV【第99回】 | GMP Platform		
【解説】軍司令官の養成にAIを活用する中国	<説明>	<tab不明-トピック>
Nx でカラー画像の黒背景を透過する	<コラム>	<tab不明-オピニオン>
バーチャル世界の利点は「思いっきり失敗できる」こと。メタバース空間が、子どもの教育に適している理由（幻冬舎ゴールドオンライン）	<コラム>	<tab不明-オピニオン>
違法な動画サイトに収益得るために見えない広告が隠されていることが判明	<技術開発>	<技術トピック>
LSBの活動は終了している? | スラド Linux	<サービス終了>,<コラム>	<製品サービス>
「サブスク」でうまくいくために必要なこと（ITmedia マーケティング）	<コラム>	<tab不明-オピニオン>
Webの基礎概念を超簡単にまとめてみた	<コラム>	<tab不明-オピニオン>
BMW Motorradが「CE 04 Vagabund Moto Concept」を公開！オーストリアの都心で暮らす若者に向けたコンセプトeスクーター（バイクのニュース）	<イベント>,<目標>	<イベント>
印テレコム最大手Reliance Jio、次世代Wi-Fi技術の米Mimosa Networksを6,000万米ドルで買収	<譲渡・買収>	<経済>
米国FDA／酸還元剤による胃のpH依存性薬物相互作用の評価に関する最終ガイダンス | GMP Platform		
Linuxで設定してはいけない“謎”の文字列「777」の正体	<コラム>	<tab不明-オピニオン>
Appleの「若者ターゲット」戦略は成功している〜CIRP調査	<戦略>,<コラム>,<調査>	<tab不明-オピニオン>
iPhoneとAndroid間でeSIM転送は無理そう？ MWCに見るスマホトレンド	<コラム>,<見解>	<tab不明-オピニオン>
HireRoo TechTalk #1 (2023/04/06 19:00〜)		
COVID-19関連のNews Release・通知等（2023年3月10日付） | GMP Platform		
【Console Application】ファイルとデータベース 247【学習記】｜SAYKA.｜note	<レポート>	<tab不明-レポート>
統合型校務支援システム「EDUCOMマネージャーC4th」、「Google Workspace for Education」「Google Classroom」とのアカウント連携機能をリリース	<技術開発>,<サービス開始>	<製品サービス>
あなたの手元にあるその「データ」、じつは「比較という方法」によって何倍にも有効活用できます（現代ビジネス）	<技術開発>,<利用・採用>,<コラム>	<技術コラム>
メアリー・ケイにとって極めて重要なこと：デジタル・イノベーションの取り組みを加速させ、女性起業家の可能性を最大限に引き出す：時事ドットコム	<コラム>,<紹介>	<tab不明-オピニオン>
【ニュートピ！ゆるいニュース (223P) 】 無料のパスワードマネージャー「Bitwarden」には別のサイトを埋め込んでパスワードを盗める欠陥があるとセキュリティ企業が報告 - GIGAZINE	<コラム>,<情報公開>	<経済>
脳トレ「川島研究室」の警鐘、ネット依存はアルコール依存と同様に危険（JBpress）		
グーグルDiscoverの掲載判断には検索のランキング要因と同じものが多い【海外＆国内SEO情報ウォッチ】	<コラム>	<tab不明-オピニオン>
人間性の進化的起源　ケヴィン・レイランド著 - 日本経済新聞	<市場動向>	<経済>
ロンツーでも快適な乗り心地　ハスクバーナ新型「Norden 901 Expedition」を発表	<コラム>,<商品化>	<製品サービス>
FFXIVデザインの500GBポータブルSSDが5,500円。2日間限定 [Sponsored]		
Plone研究会第78期 #1 (2023/03/22 19:00〜)		
全力イノベーターズ～SDGsに挑むZ世代～どこでも学べる(テレビ東京、2023/3/11 17:15 OA)の番組情報ページ	<コラム>,<芸能>	<tab不明-オピニオン>
青山学院大学総合研究所×早稲田大学先端社会科学研究所共催「第10回カーボンニュートラル研究セミナー」を開催	<セミナー>	<イベント>
【オンライン開催】Salesforce Saturday 人形町 #17 (2023/03/25 13:00〜)	<イベント>	<イベント>
SXSW、2023年の公式モバイルアプリ「SXSW GO」で重要なエクスペリエンスを支えるために、再びエアシップを採用：時事ドットコム	<コラム>,<利用・採用>	<技術コラム>
iPhone SE（第4世代）と16の独自開発5Gモデムへの過度な期待は禁物と指摘	<意見>	<tab不明-オピニオン>
servant-clientの新しいバージョンではステータスコードのチェックが厳密になっていました	<コラム>	<tab不明-オピニオン>
GIGABYTE、GeForce RTX 4070搭載のゲーミングノート		
株式会社あるやうむが「活躍が期待されるフィンテックスタートアップ」として「FIN/SUM 2023」1次選考を通過しました。：時事ドットコム	<コラム>,<表彰>	<社会>
Apple Music Classicalが一部の国々で予約注文可能に	<技術開発>	<技術トピック>
2020年7月にバルク品で登場の「Ryzen 3 4300G」がリテール版で単品販売！（ITmedia PC USER）	<商品化>	<製品サービス>
論計舎連続講義「ゲーデルの不完全性定理への12講」#08 (2023/04/29 13:30〜)		
XR（クロスリアリティ）技術を用いた展覧会。「AUGMENTED SITUATION D」が渋谷区各所でスタート（美術手帖）	<技術開発>,<サービス開始>	<製品サービス>
産官学連携によるBeyond5G機能実現型プログラムの初年度研究成果を「地域ＩｏＴと情報力コンソーシアムによるシンポジウム」で発表	<技術開発>,<業界情報>,<研究>	<経済>
【週刊まとめ読み・高校生編】親子で受験情報戦を制する、映像授業直後の記憶定着がカギ他（リセマム）	<コラム>	<tab不明-オピニオン>
習氏への信頼揺らぐ、コロナ転換の傷跡深く－中国市民の怒りくすぶる	<コラム>	<tab不明-オピニオン>
凡人が「1位思考」に変わる5大インプット法とは？（ダイヤモンド・オンライン）	<コラム>,<設備投資>	<経済>
狙うはテスラ超え！　2030年には完全自動運転車を１万台作る！　将棋の名人に勝利したAIソフトの開発者が興した「チューリング」って何？	<コラム>,<社会統計>	<社会>
iPhoneとAndroid間でeSIM転送は無理そう？ MWCに見るスマホトレンド	<コラム>,<見解>	<tab不明-オピニオン>
「AIアナウンサーGPT」β版の無料提供を開始　ChatGPT、WhisperとAPIで連携（ITmedia ビジネスオンライン）	<サービス開始>,<提携>	<製品サービス>
クラウドに関する記事のまとめ(2023.3.5～2023.3.11）：『ビジネス2.0』の視点：オルタナティブ・ブログ	<コラム>	<tab不明-オピニオン>
SXSW、2023年の公式モバイルアプリ「SXSW GO」で重要なエクスペリエンスを支えるために、再びエアシップを採用：時事ドットコム	<コラム>,<利用・採用>	<技術コラム>
ラボにおけるERESとCSV【第99回】 | GMP Platform		
【ニュートピ！ゆるいニュース (870P) 】 「初代iPhoneと同等の衝撃」と評されるOpenAIの次世代言語モデル「GPT-4」が2023年3月発表予定、画像認識機能や多言語対応の強化が実現か - GIGAZINE	<技術開発>,<コラム>	<技術コラム>
違法な動画サイトに収益得るために見えない広告が隠されていることが判明	<技術開発>	<技術トピック>
LINEと連動し省人化、注文アプリで中小支援　静岡のIT提案（あなたの静岡新聞）	<支援>	<経済>
「サブスク」でうまくいくために必要なこと（ITmedia マーケティング）	<コラム>	<tab不明-オピニオン>
印テレコム最大手Reliance Jio、次世代Wi-Fi技術の米Mimosa Networksを6,000万米ドルで買収	<譲渡・買収>	<経済>
中国の大手サーバー企業の禁輸指定、NVIDIAとAMDが対応に苦慮 |  財経新聞		
LSBの活動は終了している? | スラド Linux	<サービス終了>,<コラム>	<製品サービス>
NTTデータなど、災害時の家屋被害情報収集サービス開発　ドローン・スマホで効率化	<技術開発>	<技術トピック>
LEXUSが「NX」を一部改良して注文受付再開！インテリアのカラーリングが刷新！（WEBヤングマシン）	<技術開発>,<サービス更新>	<製品サービス>
ジェネレーティブAIの進化に潜む「膨大なCO2排出」という不都合な真実（1/3ページ）		
手首からChatGPTに質問できる！ Apple Watchアプリ「watchGPT」登場（GetNavi web）	<コラム>,<商品化>	<製品サービス>
“VRからやってきたゾンビ”を、AR越しに銃で撃つ！ 実証実験中のXRアトラクションに注目【SMS「EMBARK」レポート】	<社会事件>,<コラム>,<技術動向>	<技術コラム>
ＳＶＢ、情報不足でさらに事態悪化－増資実現をアナリスト疑問視	<技術開発>	<技術トピック>
FFXIVデザインの500GBポータブルSSDが5,500円。2日間限定 [Sponsored]		
米国FDA／酸還元剤による胃のpH依存性薬物相互作用の評価に関する最終ガイダンス | GMP Platform		
GIGABYTE、GeForce RTX 4070搭載のゲーミングノート		
米銀ＳＶＢ株、急落後に売買停止－増資失敗で身売り交渉と報道	<障害>,<サービス終了>,<コラム>	<製品サービス>
7インチの画面を搭載した次世代HomePodが2024年前半に発売か。著名アナリストが伝える	<商品化>,<コラム>	<製品サービス>
統合型校務支援システム「EDUCOMマネージャーC4th」、「Google Workspace for Education」「Google Classroom」とのアカウント連携機能をリリース	<技術開発>,<サービス開始>	<製品サービス>
メアリー・ケイにとって極めて重要なこと：デジタル・イノベーションの取り組みを加速させ、女性起業家の可能性を最大限に引き出す：時事ドットコム	<コラム>,<紹介>	<tab不明-オピニオン>
ロンツーでも快適な乗り心地　ハスクバーナ新型「Norden 901 Expedition」を発表	<コラム>,<商品化>	<製品サービス>
【オンライン開催】Salesforce Saturday 人形町 #17 (2023/03/25 13:00〜)	<イベント>	<イベント>
Nx でカラー画像の黒背景を透過する	<コラム>	<tab不明-オピニオン>
HireRoo TechTalk #1 (2023/04/06 19:00〜)		
米銀行業界、ＳＶＢ混乱の波及リスクを抑え込める－エラリアン氏	<コラム>	<tab不明-オピニオン>
《日経Robotics》カチャカ：スマートファニチャー空間を実現するエンジン	<技術開発>	<技術トピック>
睡眠改善に役立つ機能が満載！　EPEIOSのデザイン加湿器「Heal」をじっくりレビューしてみた - BCN＋R	<レポート>,<コラム>	<tab不明-オピニオン>
XR（クロスリアリティ）技術を用いた展覧会。「AUGMENTED SITUATION D」が渋谷区各所でスタート（美術手帖）	<技術開発>,<サービス開始>	<製品サービス>
マイクロソフト、量子と古典コンピューターを統合「Azure Quantum」新ハイブリッド機能を公開（アスキー）	<イベント>	<イベント>
今週のAI/人工知能ニュースまとめ 2023/3/11｜いおきたかゆき｜note	<コラム>	<tab不明-オピニオン>
トヨタ、水を電気分解して水素を製造する「水電解装置」を新開発 FCEV「MIRAI」の技術を活用、デンソー福島工場で稼働開始	<技術開発>,<サービス開始>,<設備投資>	<製品サービス>
廃棄衣料繊維を原料としたサステナブルなボード「PANECO（パネコ）」がクラウドファンディングサイト「CAMPFIRE（キャンプファイヤー）」にてプロジェクト開始。	<サービス開始>,<設立>	<製品サービス>
株式会社あるやうむが「活躍が期待されるフィンテックスタートアップ」として「FIN/SUM 2023」1次選考を通過しました。：時事ドットコム	<コラム>,<表彰>	<社会>
2020年7月にバルク品で登場の「Ryzen 3 4300G」がリテール版で単品販売！（ITmedia PC USER）	<商品化>	<製品サービス>
《日経Robotics》デンソーITラボが新アンサンブル学習技術、ベイジアンニューラルネットで最高水準の精度や頑健性	<技術開発>	<技術トピック>
7-Eleven／Speedwayとの統合で、2023年度に8億ドルのシナジー見込む	<コラム>	<tab不明-オピニオン>
EVバイクレンタルサービス開始式｜東京都		
3/17「電動化対応自動車部品 サプライヤー支援セミナー」|湖西市	<セミナー>	<イベント>
令和トラベル、ワイキキ支店をオープン	<サービス開始>	<製品サービス>
NVIDIA、WindowsでCPU使用率が高くなる問題を修正する緊急パッチリリース		
【デモデイ開催レポート】Japan Summit Winter/Spring 2023 Batch Kyoto Edition Report：時事ドットコム	<イベント>,<レポート>,<実験>	<イベント>
COVID-19関連のNews Release・通知等（2023年3月10日付） | GMP Platform		
1週間のM&A速報まとめ（2023年3月6日〜2023年3月10日）	<コラム>	<tab不明-オピニオン>
日産e-POWERの未来【池田直渡の5分でわかるクルマ経済】（グーネット）(ヘッドライン) | 自動車情報サイト【新車・中古車】 - carview!	<コラム>,<市場動向>	<経済>
サーバーを“オイル漬け”？？　デジタル社会、新冷却技術で省電力化【けいざい百景】（時事通信）	<コラム>,<技術開発>	<技術コラム>
【人気モデル 購入最前線】日産 エクストレイル編（2023年3月）（WEBヤングマシン）	<コラム>	<tab不明-オピニオン>
トヨタ・ハイラックス　詳細データテスト　オンよりオフの走りで本領発揮　乗り心地には改善の余地あり（AUTOCAR JAPAN）	<実験>,<効果>	<技術トピック>
個性際立つ「レンジローバースポーツ」の3代目はレンジローバーにはない俊敏なドライブを楽しめる	<コラム>	<tab不明-オピニオン>
驚異でしかないヒョンデとBYDのEV！　日本車の巻き返しは「フリート販売」にあり（WEB CARTOP）	<コラム>	<tab不明-オピニオン>
三菱「イケ顔四駆」の品質がスゴい！ アウトドアユーザーも注目な「トライトン」がタイ製品調査でクラス最高ランク獲得（くるまのニュース）	<コラム>	<tab不明-オピニオン>
【デンマーク】イネオス、ベルギー工場で回収したCO2を北海海底に貯留。注入開始。越境輸送は世界初 | Sustainable Japan | 世界のサステナビリティ・ESG投資・SDGs	<技術開発>,<投資>,<社会問題>	<経済>
思わぬ理由で決まった、車高の秘密。３列シート車の革命児 “ホンダ・オデッセイ” で誕生で、国産ミニバンシーンが大きく動いた！【連載「ミニバンの起源」第3回 ブームの名車たち 前編】	<コラム>	<tab不明-オピニオン>
富士通ゼネラル、英仏軸にＡＴＷ拡充／開発体制増強、現地新工場も | 電気新聞ウェブサイト	<方針>,<設備投資>	<経済>
【ニュートピ！ゆるいニュース (4842P) 】 【やじうまPC Watch】核融合研、放射線出さない核融合反応に世界初成功 - PC Watch	<技術開発>	<技術トピック>
【クルマら部】クルマ愛クイズ！今回は「歴代ミラージュ」から全4問！ | レスポンス（Response.jp）		
“2035年に新車すべて電動車”と発表　三菱自動車（FNNプライムオンライン（フジテレビ系））		
リアル“農道のポルシェ”奇跡の現存 真っ赤なポルシェのトラクターが“日本製”のナゼ しかも動くぞ！（乗りものニュース）	<コラム>	<tab不明-オピニオン>
いまの食料供給の仕組みが続くと、それだけで平均気温が「1℃上昇」する：研究結果（WIRED.jp）		
人工石油の「ドリーム燃料製造装置」、開発者「永久機関的」		
経済的に「お得」だからディーゼル車を買う……は間違い！　そうそう埋められない「ガソリン車」との差	<コラム>	<tab不明-オピニオン>
家族の楽しさ広がるSUV　10選　激戦区の欧州で鍛え抜かれた万能ファミリーカー（AUTOCAR JAPAN）	<紹介>,<レポート>	<tab不明-トピック>
いすゞ次期社長・南真介氏、脱炭素へ「宇宙人」の突破力 - 日本経済新聞	<コラム>,<市場動向>	<経済>
三菱自動車、３５年度には販売全てを電動車へ　１兆円超投資：中日新聞Web	<目標>,<投資>	<経済>
"オーガニックの野菜やフルーツは栄養が豊富"は本当だった！英国研究チームの成果をご紹介｜はたけもん｜note	<紹介>	<tab不明-トピック>
焦点：バングラ繊維産業、気候変動が脅威　雇用確保にも課題	<コラム>,<社会事件>,<社会問題>	<社会>
新車の当たり年の可能性大！ 2023年の自動車業界を見通す（webCG）		
世界初の可変マス機構を誇った専用設計650ccツイン「スズキGR650」［1983］……隆盛の陰に短命車あり【1980～2000年代に起こったバイクの改変　その6】（モーサイ）	<コラム>	<tab不明-オピニオン>
ちょっと古いメルセデス・ベンツがよみがえる場所！　ヤナセ・クラシックセンター潜入（？）リポート！！（ENGINE WEB）		
いすゞ自動車次期社長　南真介氏 - 日本経済新聞	<コラム>,<市場動向>	<経済>
丸目のレトロ感スゴイ！ トヨタ「ヤリス 高級仕様」登場!? MTも設定の新コンパクト「ビュート ストーリー」の特徴とは	<コラム>,<商品化>	<製品サービス>
何をやってる研究所？　交通安全環境研究所がWebで一般公開中！（くるくら）	<コラム>,<イベント>	<イベント>
「攻撃されている！　あなたも防御の準備をして！」最先端科学が、植物の“おしゃべり”を突き止めた！（ＮＨＫスペシャル取材班＋緑慎也）	<社会事件>,<コラム>	<社会>
高騰した電気代下げるには「安全・新型」の原発が生命線　火力発電技術の強化も（夕刊フジ）	<コラム>,<技術開発>	<技術コラム>
『人間の建設』No.26 破壊だけの自然科学 2｜らいとらいたあ｜note		
【ルポ】「日本が独占していた設備を国産化して世界首位に」…ディスプレーを加工する未来カンパニー（上）（朝鮮日報日本語版）	<業界情報>,<レポート>	<経済>
政府が福島第一原発推進に舵切るも… 使用済み核燃料問題が再注目（ABEMA TIMES）	<コラム>,<技術動向>	<技術コラム>
ダムドのフルエアロをまとった「WRX STI」が「eモータースポーツ」で走る！ でもなぜダムドが冠スポンサーに？（Auto Messe Web）	<コラム>,<支援>	<経済>
脳トレ「川島研究室」の警鐘、ネット依存はアルコール依存と同様に危険（JBpress）		
もんじゅ燃料搬出の知見、高速炉に／原子力機構など、稼働率向上へ | 電気新聞ウェブサイト	<技術開発>,<目標>	<技術トピック>
ロータスの電動SUV『エレトレ』、ZFの新開発ソフト初搭載…シャシー全体とEVドライブを制御	<技術開発>	<技術トピック>
すべての部品を米国内で製造するとiPhoneの価格は100ドル上がる	<生産活動>,<コラム>	<製品サービス>
フェラーリを8人で共同所有　最年少27歳オーナー「342万円以上の価値」はプライスレス（ENCOUNT）		
《日経Robotics》デンソーITラボが新アンサンブル学習技術、ベイジアンニューラルネットで最高水準の精度や頑健性	<技術開発>	<技術トピック>
Webの基礎概念を超簡単にまとめてみた	<コラム>	<tab不明-オピニオン>
ジェネレーティブAIの進化に潜む「膨大なCO2排出」という不都合な真実（1/3ページ）		
トヨタ・ハリアー「旧型モデル」人気衰えず【新型vs旧型】魅力を比較（LIMO）	<コラム>,<障害>	<社会>
国産セダンが相次いで廃止！ 日産・ホンダは1車種のみ!? セダンがサッパリ売れなくなった訳（くるまのニュース）	<業界情報>,<サービス終了>,<コラム>	<製品サービス>
【どれにする？】BMW 3シリーズ対メルセデスCクラス対VWパサート　ベストセラー3台を徹底比較　46枚もの写真付き！（AUTO BILD JAPAN Web）	<コラム>	<tab不明-オピニオン>
トヨタ小型SUV「C-HR」生産終了！ 2023年7月で6年半の歴史に幕 公式サイトで告知へ（くるまのニュース）	<サービス終了>,<生産活動>	<製品サービス>
水戻し不要の代替肉生産強化へ、亀田製菓（新潟江南区）子会社「マイセンファインフード」が新工場　欧州製加工機器を国内初導入	<生産活動>,<目標>,<設備投資>,<方針>,<利用・採用>	<製品サービス>
